-ability	做词根时的意思：<br />表名词，能…；性质<br />eg：<br />variability<br />变化性，易变，变化的倾向；变率；<br />dependability<br />可信任，可靠性；<br />adaptability<br />适应性；合用性；	***************<br />做单词时的意思：<br />n.<br />能力，资格；能耐，才能；
-able	做词根时的意思：<br />形容词后缀，having the quality of ，表示具<br />eg：<br />acceptable<br />可接受的；合意的；（社会上）认同的；（礼物等）令人满意的；<br />comparable<br />可比较的；比得上的；<br />desirable<br />令人满意的；值得拥有的；可取的；性感的；  称心如意的人[东西]；	***************<br />做单词时的意思：<br />adj.<br />能够的；有能力的；有才干的；干练的；
-ably	做词根时的意思：<br />表副词，能…地<br />eg：<br />lovable<br />可爱的；惹人爱的；<br />suitably<br />适当地，适宜地；相配地；合适地；	***************<br />做单词时的意思：<br />adv.<br />精明强干地；灵巧地；巧妙地；熟练地；
-acious	做词根时的意思：<br />表形容词，有特征的，多…的<br />eg：<br />rapacious<br />贪婪的；（尤指）贪财的；抢劫的；掠夺的；<br />sagacious<br />精明的，有判断力的；明智；睿哲；哲；<br />capacious<br />宽敞的，气度宏大的；	***************<br />做单词时的意思：
-acity	做词根时的意思：<br />表名词，有…倾向<br />eg：<br />capacity<br />容量；才能；性能；生产能力；  充其量的，最大限度的；<br />veracity<br />诚实，真实；<br />tenacity<br />[物]韧性，韧度；固执，坚持；不屈不挠；黏性；	***************<br />做单词时的意思：
-acy	做词根时的意思：<br />表名词,性质，状态<br />eg：<br />fallacy<br />谬误，谬见；谬论；错误；<br />supremacy<br />至高无上；最高权力；最高地位；霸权；<br />intimacy<br />亲密；亲近；亲昵的言行；性行为；	***************<br />做单词时的意思：<br />abbr.<br />average crop yield 农作物平均产量；
-ade	做词根时的意思：<br />表名词,状态，物品<br />eg：<br />blockade<br />封锁；封锁部队；障碍物，阻碍物；  实行封锁；阻塞，挡住；<br />decade<br />十年，十年间；十个一组；十年期；<br />cascade<br />倾泻；小瀑布，瀑布状物；串联；  流注；大量落下；	***************<br />做单词时的意思：<br />n.<br />果汁饮料；
-age	做词根时的意思：<br />名词后缀，表示状态、行为、结果或关系<br />eg：<br />blockage<br />堵塞，堵塞物；[医]（心理）阻滞；封锁（状态）；妨碍；<br />coverage<br />范围，规模；保险项目；（新闻）报导；[植]优势度；<br />drainage<br />排水，放水；排水系统；排走物，废水；排水区域；	***************<br />做单词时的意思：<br />n.<br />年龄；时代；老年；年龄段；<br />vt.& vi.<br />（使）长大；使显老；使变老；使苍老；<br />vi.<br />[化学]老化；陈化，熟化；（吸毒者随年龄增长而主动）戒毒，戒除毒<br />vt.<br />[化学]使老化；使陈化；使熟化；估计，推测（马的年龄）；
-ain	做词根时的意思：<br />表名词，…人<br />eg：<br />captain<br />船长，机长；领袖，首领；上尉；（美国警察局的）副巡长；  当首领；统帅或指挥；<br />riverain<br />河的，河边的；  住在河边的人；<br />villain<br />（小说、戏剧等中的）反面人物；罪犯；恶棍；淘气鬼，顽童；	***************<br />做单词时的意思：<br />adj.<br /><英方>自己的；
-aire	做词根时的意思：<br />名词后缀<br />eg：<br />millionaire<br />百万富翁；大富翁；大财主；有钱人；  100万以上人口的；<br />questionnaire<br />调查表；调查问卷；	***************<br />做单词时的意思：<br />abbr.<br />acute infarction ramipril effica
-al	做词根时的意思：<br />名词后缀，跟在动词后<br />eg：<br />arrival<br />到达，抵达；出现，登场；新生婴儿；到达者；<br />burial<br />葬，掩埋；葬礼；<br />denial<br />否认，否定；克制；拒绝，拒绝接受；	***************<br />做单词时的意思：<br />abbr.<br />alii (=other persons) （拉丁语）其他人；a
-ality	做词根时的意思：<br />表名词，状态，性质<br />eg：<br />personality<br />生而为人；人格，人品，个性；人物；名人；<br />nationality<br />国籍；国家；民族性；部落；<br />hospitality<br />殷勤好客；招待，款待；（气候，环境等的）宜人，适宜；	***************<br />做单词时的意思：
-ance	做词根时的意思：<br />与动词结合，构成名词，表示动作、行为过程或状态<br />eg：<br />alliance<br />（国家、政党等的）结盟，同盟，联盟，联合；联姻；同盟条约；同盟者<br />appearance<br />外貌，外观；出现，露面；[哲]现象；<br />endurance<br />耐久（力），持久（力）；忍耐，忍耐力；	***************<br />做单词时的意思：<br />[地名] [法国] 昂斯河；
-ancy	做词根时的意思：<br />名词后缀，同ance，性质，状况<br />eg：<br />ascendancy<br />优势，支配地位；支配倾向；<br />redundancy<br />过多，过剩；冗长；裁员；（机器的）多余度；<br />elegancy<br />优美，优雅；	***************<br />做单词时的意思：
-aneity	做词根时的意思：<br />表名词，性质<br />eg：<br />spontaneity<br />自发性，自然发生；自发行为[行动]；<br />simultaneity<br />同时发生，同时；同时性；<br />instantaneity<br />瞬时性，即时性；	***************<br />做单词时的意思：
-aneous	做词根时的意思：<br />表形容词，…有；…特征的<br />eg：<br />simultaneous<br />同时发生的，同时存在的；同时的；联立的；  同时译员；<br />spontaneous<br />自发的；自然的；天然产生的；无意识的；<br />miscellaneous<br />各种各样的；五花八门的；混杂的；多方面的；	***************<br />做单词时的意思：
-ant	做词根时的意思：<br />与动词结合，构成名词<br />eg：<br />accountant<br />会计人员，会计师；<br />applicant<br />申请人，求职人；请求者；<br />defendant<br />[法]被告人；  [法]被告的；辩护的；	***************<br />做单词时的意思：<br />n.<br />蚂蚁；
-ar	做词根时的意思：<br />表形容词，…的<br />eg：<br />titular<br />（有）称号的；（有）头衔的；名义上的；书名的；  只有名义（或头衔）的人；<br />vulgar<br />庸俗的，俚俗的，粗俗的；一般大众的，老百姓的；粗野的，下流的；  [古语]平民，百姓；<br />linear<br />直线的，线形的；长度的；<数>一次的，线性的；通过单独的若干阶段	***************<br />做单词时的意思：<br />abbr.<br />Argentina 阿根廷；Army Regulation 陆军
-ard	做词根时的意思：<br />表名词，不好的人<br />eg：<br />laggard<br />落后者；<br />coward<br />胆小鬼，懦夫；  怯懦的，胆小的；<br />niggard<br />小气的人，吝啬鬼；小气鬼；	***************<br />做单词时的意思：<br />abbr.<br />acute reference doses 急性药剂；arter
-arian	做词根时的意思：<br />表形容词或名词，…的(人)<br />eg：<br />humanitarian<br />人道主义的；博爱的；慈善的；  人道主义者；慈善家；博爱主义者；<br />vegetarian<br />素食者；食草动物；  素食者的；素菜的；<br />utilitarian<br />功利的；功利主义的，实利主义的；有效用的；实用的；  功利主义者；实用主义者；	***************<br />做单词时的意思：<br />adj.<br />阿里乌斯派的；<br />n.<br />阿里乌斯派信徒；
-arium	做词根时的意思：<br />表名词，地点，场所<br />eg：<br />oceanarium<br />大型海洋水族馆；<br />sanitarium<br /><美>疗养院；	***************<br />做单词时的意思：
-ary	做词根时的意思：<br />与名词结合，构成形容词<br />eg：<br />complimentary<br />表示敬意的；赞美的；恭维的；赠送的；  崇敬地，赞美地，赞许地；<br />imaginary<br />想像中的，假想的，虚构的；[数]虚数的；幻；虚幻；<br />legendary<br />传说的；传奇的；极其著名的；  传说集；[宗]圣徒传；	***************<br />做单词时的意思：<br />氩；<br />0<br />氩；
-ast	做词根时的意思：<br />表名词，…人，物<br />eg：<br />encomiast<br />宣读或写颂辞的人，阿谀者，赞美者；<br />ballast<br />压舱物，压载物；道渣，碎石；镇流器；<比喻>沉着；  给某物装上压舱物；给…铺道渣；使稳定；使沉着；<br />enthusiast<br />热情者，热心者；热衷于…的人；狂热者；宗教狂；	***************<br />做单词时的意思：<br />abbr.<br />astronomy 天文学；absolute space-tim
-ate	做词根时的意思：<br />形容词后缀，加在动词或名词后面<br />eg：<br />considerate<br />体贴的，体谅的；深思熟虑；到；慎重；<br />fortunate<br />侥幸的，幸运的；带来幸运的，吉利的；  有好运的人；<br />passionate<br />热烈的；激昂的；易怒的；易被情欲所支配的；	***************<br />做单词时的意思：<br />abbr.<br />Automatic Test Equipment 自动试验设备；<br />v.<br />吃（过去式）；
-atic	做词根时的意思：<br />表形容词，有…性质的<br />eg：<br />pragmatic<br />实际的；实用主义的；好管闲事的；国事的；  爱管闲事的人；专断的人；国事诏书；实务家；<br />phlegmatic<br />冷静的；镇定的；迟钝的；冷漠的；<br />aromatic<br />芳香的，有香味的；[化]芳香族的；  芳香植物；芳香剂，香料；	***************<br />做单词时的意思：<br />abbr.<br />Aerospace Technical Intelligence
-ation	做词根时的意思：<br />表名词，行为，过程，结果<br />eg：<br />approbation<br />认可；许可；批准；赞许；<br />falsification<br />弄虚作假，歪曲；畸变；证明为假；<br />provocation<br />挑衅，挑拨；激怒，刺激；愤怒；愤怒的原因；	***************<br />做单词时的意思：<br />增强辐射，文明阶段；
-ative	做词根时的意思：<br />表形容词,有…倾向(性质)的<br />eg：<br />preservative<br />防腐剂；预防法；防护层；  防腐的，（能）保存的；储藏的；有保护力的；<br />lucrative<br />获利多的，赚钱的；合算的；<br />figurative<br />比喻的；修饰多的；象征的；呈现的；	***************<br />做单词时的意思：
-ator	做词根时的意思：<br />表名词，做事的人或物<br />eg：<br />gladiator<br /><史>斗剑士，格斗士；<br />dictator<br />独裁者；专制者；发号施令者；专横的人；<br />generator<br />发电机，发生器；电力公司；生产者，创始者；[乐]基础低音；	***************<br />做单词时的意思：<br />除氧器滑压运行；
-cy	做词根时的意思：<br />加在形容词或名词后面，构成名词<br />eg：<br />accuracy<br />精确（性），准确（性）；<br />bankruptcy<br />破产，倒闭；彻底失败；（勇气）完全丧失；<br />presidency<br />总统；总统的任期；管辖；支配；	***************<br />做单词时的意思：<br />Cyprus 塞浦路斯；
-dom	做词根时的意思：<br />名词后缀<br />eg：<br />boredom<br />讨厌，令人讨厌的事物；无聊，无趣；厌倦；<br />freedom<br />自由，自主；直率；特权，特许；自由权；<br />wisdom<br />智慧，明智；常识，好的判断力；知识，学问；古训；	***************<br />做单词时的意思：<br />abbr.<br />domenica (Italian=Sunday) （意大利语）
-ee	做词根时的意思：<br />与及物动词结合，构成名词，一般表示受动者<br />eg：<br />employee<br />雇工，雇员，职工；<br />nominee<br />被提名者，候选人；被任命者；代名人；<br />devotee<br />热爱者，迷恋者；皈依者；信徒；	***************<br />做单词时的意思：<br />abbr.<br />excess 超过；electric eye 电眼；eve an
-eer	做词根时的意思：<br />名词后缀，人员<br />eg：<br />profiteer<br />投机，牟求暴利；  [贸易] 奸商；牟取暴利的人；<br />engineer<br />工程师，技师；（轮船的）机师；〈美〉（火车的）司机，；（陆军的） 设计，策划；安排或处理；改变…的基因（或遗传）结构；<br />volunteer<br />志愿者，志愿兵；[军]义勇军；[植]自生植物；[林]先锋树种；  自愿的，志愿的；  自愿去做；当志愿兵[义勇军]；  志愿，义务服务；  志愿提供；	***************<br />做单词时的意思：<br />adv.<br />无论何时，曾经；
-el	做词根时的意思：<br />表名词，人或物<br />eg：<br />personnel<br />全体员工；（与复数动词连用）人员，员工；人事部门；<br />colonel<br />上校；<br />wastrel<br />无用的人，废物；浪子；	***************<br />做单词时的意思：<br />abbr.<br />elevation 仰角；electric(ity) 电（的）；
-er	做词根时的意思：<br />名词后缀，表人、物、工具等<br />eg：<br />manager<br />处理者，经理，管理人；干事，理事；〈美〉（政党等的）领袖；策士，<br />computer<br />（电子）计算机，电脑；<br />winner<br />获胜的人；胜券在握；制胜的一记入球；成功的东西；	***************<br />做单词时的意思：<br />int.<br />（思索该说什么话时发出的声音）哦，嗯；
-fier	做词根时的意思：<br />表名词，“人和物”，由-ify转化而来<br />eg：<br />liquefier<br />液化器，液化器操作工；<br />amplifier<br />扩音器；放大器；扩大的人；详述者；<br />falsifier<br />弄虚作假者，伪造者；	***************<br />做单词时的意思：<br />abbr.<br />Foundation for Instrumentation E
-ible	做词根时的意思：<br />形容词后缀，具备某些品质<br />eg：<br />flexible<br />灵活的；易弯曲的；柔韧的；易被说服的；<br />possible<br />可能的；可接受的；合理的，可以允许的；不坏的；  可能性，潜在性；可能的人物，可能有的事；最高分；	***************<br />做单词时的意思：
-ics	做词根时的意思：<br />表名词，“学科，学术”<br />eg：<br />pediatrics<br />小儿科；儿科学；幼科；<br />metaphysics<br />形而上学，玄学；<br />homiletics<br />（用作单数）讲道术，说教术；	***************<br />做单词时的意思：<br />abbr.<br />installment credit selling 分期付款赊
-id	做词根时的意思：<br />表形容词，“如…的”<br />eg：<br />florid<br />红润的；华丽的；炫耀的；绚丽；<br />stupid<br />愚蠢的；迟钝的；乏味的；晕眩的，昏迷不醒的；  <口>傻子，笨蛋；<br />splendid<br />壮观的，豪华的；极好的或令人满意的；闪亮的；为众人所推崇的；	***************<br />做单词时的意思：<br />n.<br />遗传素质；本能冲动；身份证；标识符；
-ie	做词根时的意思：<br />表名词，“小东西或人”<br />eg：<br />coterie<br />（有共同兴趣的）小集团；<br />rookie<br />新手；新队员；<br />movie<br />电影；电影院；电影业；	***************<br />做单词时的意思：<br />abbr.<br />Ireland 爱尔兰共和国；
-ier	做词根时的意思：<br />表名词，“人或物”<br />eg：<br />cashier<br />出纳员；  解雇；抛弃；<br />cavalier<br />对女人彬彬有礼的绅士；对女人献殷勤的男子；<古>骑士；<史>英内 随便的；傲慢的；漫不经心的；不在乎的；<br />chandelier<br />枝形吊灯；	***************<br />做单词时的意思：<br />乘数；
-ific	做词根时的意思：<br />表形容词，“产生…的”<br />eg：<br />scientific<br />科学的；有系统的；应用科学的；精通学理的，有学问的；<br />horrific<br />令人恐惧的，可怕的，恐怖的；令人毛骨悚然的；<br />prolific<br />（艺术家、作家等）多产的；众多的；富饶的；（植物、动物等）丰硕的	***************<br />做单词时的意思：<br />abbr.<br />International Food Information C
-ification	做词根时的意思：<br />表名词，由ific变化而来<br />eg：<br />amplification<br />扩大；发挥；<物>振幅；放大率；<br />modification<br />修改，修正，变更，改良，改进，缓和，减轻，限制；[语]修饰，（用<br />clarification<br />（液体的）澄清；净化；澄清法；（意义等的）澄清、说明；	***************<br />做单词时的意思：
-ile	做词根时的意思：<br />表形容词，“…的”<br />eg：<br />servile<br />过分屈从的；缺乏独立性的；（似）仆人的；为仆人的；<br />juvenile<br />少年的；幼稚的，年少无知的；幼稚的；  青少年；扮演少年角色的演员；少年读物；羽毛未丰的鸟，雏鸟；<br />fertile<br />肥沃的；可繁殖的；想象力丰富的；	***************<br />做单词时的意思：<br />suf.<br />（构成形容词和名词）表示“能”，“倾向”，“关系”；
-ine	做词根时的意思：<br />表形容词，“…的”<br />eg：<br />elephantine<br />象的；巨大的；笨拙的；沉重的；<br />porcine<br />猪的，似猪的；<br />canine<br />犬的；狗的；似犬的；犬科的；  犬齿；犬牙；犬科动物；	***************<br />做单词时的意思：<br />国际网工程备忘录；
-ing	做词根时的意思：<br />表名词，“状态”<br />eg：<br />feeling<br />感觉，知觉，情绪；感情；气氛；  富有感情的，有感觉的；有同情心的，仁慈的；  感觉；认为(feel的现在分词)；<br />gloaming<br />黄昏，薄暮；暮色；<br />clothing<br />衣服；服装；[航]帆装；  覆盖(clothe的现在分词)；给…提供衣服；	***************<br />做单词时的意思：<br />-ing（用以构成规则动词的现在分词）；
-ion	做词根时的意思：<br />表名词，“动作或状态 ”<br />eg：<br />propulsion<br />推进；推进力；<br />expansion<br />扩大；扩张；扩张物；膨胀物；<br />aversion<br />厌恶；讨厌的人或东西；<废>转变方向；背离；	***************<br />做单词时的意思：<br />n.<br /><物>离子；
-ior	做词根时的意思：<br />表形容词，“较…的”<br />eg：<br />anterior<br />位于前部的；先前的；早期的；（逻辑上）在前的；<br />posterior<br />（时间上）较晚的；在后的；后面的；尾部的；  身体后部，臀部；<br />exterior<br />外部，外面，表面，外形，外观；外貌；[影视]外景，[戏，影视]户 外面的，外部的，外表上的，表面的；	***************<br />做单词时的意思：<br />abbr.<br />input/output register 输入/输出寄存器；i
-ious	做词根时的意思：<br />表形容词，“…的”<br />eg：<br />curious<br />好奇的； 好求知的；奇妙的； 稀奇的；<br />contagious<br />有传染性的；传染病的；有感染力的；会蔓延的；<br />specious<br />似是而非的；  似是而非地；	***************<br />做单词时的意思：<br />abbr.<br />intraoperative ultrasonography 术
-ise	做词根时的意思：<br />表动词后缀，和-ize相同，是-ize的变体，“…化”<br />eg：<br />advertise<br />做广告，做宣传；通告，通知；宣扬；  登广告，做广告；做宣传；<br />publicize<br />宣传；推广；宣扬；传播；<br />aggrandize<br />扩大某人的权力；提高某人的地位；夸大；吹捧；	***************<br />做单词时的意思：<br />abbr.<br />integral square error 积分平方误差，平方误
-ish	做词根时的意思：<br />表形容词，“像…一样，有的…”，通常放在一具体名词后<br />eg：<br />snobbish<br />势利眼的；谄上傲下的；恃才傲物的；假充内行的；<br />faddish<br />好赶时髦的；一时流行的；<br />modish<br />流行的，时髦的；	***************<br />做单词时的意思：<br />[医][=interhemispheric subdural h
-ism	做词根时的意思：<br />表示“各种主义，宗教”<br />eg：<br />empiricism<br /><哲>实证论，经验主义，经验论；<br />eclecticism<br />折中主义者；<br />optimism<br />乐观；乐观主义；	***************<br />做单词时的意思：<br />n.<br />论，说，主义；
-ist	做词根时的意思：<br />表名词，“表示信仰者，专家或从事某活动的人”<br />eg：<br />feminist<br />男女平等主义者，女权扩张论者；<br />philatelist<br />集邮家；<br />dentist<br />牙科医生；	***************<br />做单词时的意思：<br />abbr.<br />istituto (Italian=institute) （意大
-istic	做词根时的意思：<br />表形容词，由-ist + ic构成，表示“…的”<br />eg：<br />artistic<br />艺术的；有美感的；风雅的；（尤指）有美术才能的；<br />humanistic<br />人文主义的；<br />moralistic<br />说教的；道学的；道德家的；注意道德的；	***************<br />做单词时的意思：<br />abbr.<br />Institute of Science and Technic
-it	做词根时的意思：<br />表名词，通常是抽象名词<br />eg：<br />spirit<br />精神，心灵；情绪；勇气；精髓；  神秘地带走；<br />credit<br />信誉，信用；[金融]贷款；荣誉；学分；  相信，信任；归功于；[会]记入贷方；赞颂；<br />pursuit<br />追赶；工作；	***************<br />做单词时的意思：<br />pron.<br />它；他；正好是所需的；事实[情况]；<br />n.<br /><美俚>傻瓜，笨蛋；<俚>绝妙的人；理想的东西；登峰造极；
-ite	做词根时的意思：<br />表形容词，“…的”<br />eg：<br />polite<br />有礼貌的；有教养的，文雅的；上流社会的；应酬的，客套的；<br />definite<br />明确的；一定的；肯定；有把握；<br />erudite<br />博学的，有学问的；笃行不倦；渊深；渊识博学；	***************<br />做单词时的意思：<br />abbr.<br />Institute of Traffic Engineers <
-itious	做词根时的意思：<br />表形容词，-ition变化而来，表示“…的”<br />eg：<br />factitious<br />不自然的；虚假的；人为的；人造的；<br />expeditious<br />迅速而有效率的，迅速完成的；<br />fictitious<br />虚构的，编造的；假定的，虚设的；小说式的；假装的；	***************<br />做单词时的意思：
-itive	做词根时的意思：<br />表形容词，“…的”<br />eg：<br />competitive<br />竞争的，比赛的；（价格等）有竞争力的；（指人）好竞争的；[生化]<br />definitive<br />最后的；确定的，决定性的；不可更改的；限定的，明确的；  限定词；<br />primitive<br />原始的；发展水平低的；落后的；[生物学]原生的；  原始人；早期的艺术家（作品）；单纯的人：不世故的人；自学的艺术家	***************<br />做单词时的意思：
-itor	做词根时的意思：<br />表名词，“人”<br />eg：<br />progenitor<br />祖先；先驱；前辈；原本；<br />expositor<br />说明者，解释者，评注者；<br />janitor<br />看门人；看管房屋的人；锅炉工；	***************<br />做单词时的意思：<br />abbr.<br />intercept target optical reader
-itude	做词根时的意思：<br />表名词，“性质，状态等”<br />eg：<br />longitude<br />经度，经线；[天]黄经；<br />latitude<br />纬度；范围；[天]黄纬；<br />attitude<br />态度；看法；姿势；个人风格；	***************<br />做单词时的意思：
-ity	做词根时的意思：<br />表名词，指具备某种性质<br />eg：<br />probity<br />正直，诚实；<br />duplicity<br />表里不一；欺骗，欺诈；双重性；<br />rigidity<br />坚硬；严格；刚直；死板；	***************<br />做单词时的意思：<br />内外之合说；<br />0<br />内外之合说；
-ive	做词根时的意思：<br />表形容词<br />eg：<br />incisive<br />直接的；尖锐的；深刻的；单刀直入的；<br />repulsive<br />令人厌恶的，可憎的；丑恶；<br />pensive<br />沉思的，深思的；	***************<br />做单词时的意思：<br />[医][=vinyl isobutyl ether]乙烯基异丁基<br />0<br />[医][=vinyl isobutyl ether]乙烯基异丁基
-ivity	做词根时的意思：<br />表名词，由-ive + ity组成，“有…能力或特性”<br />eg：<br />productivity<br />生产率，生产力；[经济学] 生产率；[生态学]生产率；<br />activity<br />活动；活跃，敏捷；活动力；教育活动；<br />conductivity<br />传导性，传导率，电导率；	***************<br />做单词时的意思：<br />智力活动内化说；<br />0<br />智力活动内化说；
-ixation	做词根时的意思：<br />表名词,来自-ize + ation,“…化”或“发展过程”<br />eg：<br />industrialization<br />工业化；<br />normalization<br />正常化；标准化；正态化；<br />centralization<br />集中；集中化；	***************<br />做单词时的意思：
-kin	做词根时的意思：<br />表名词，“小…”<br />eg：<br />napkin<br />餐巾，餐巾纸；尿布；（女士）卫生巾；<br />cannikin<br />小罐，小杯，<方>木（水）桶；<br />ladykin<br />小妇女，小女人；	***************<br />做单词时的意思：<br />n.<br />亲戚；家族，门第；亲属关系；<br />adj.<br />有亲属关系的；同类的；
-less	做词根时的意思：<br />表形容词,""无…的,不…的”<br />eg：<br />spineless<br /><贬>没有骨气的，懦弱的；（动物）无脊椎的；<br />feckless<br />没有价值的，没有长远目标的，不负责任的；  没有价值地，没有长远目标地，不负责任地；  没有价值，没有长远目标，不负责任；<br />hapless<br />倒霉的，不幸的；	***************<br />做单词时的意思：<br />adj.<br />较少的（little的比较级）；较小的；较次的，较劣的；较不重要<br />adv.<br />较少地，较小地；<br />prep.<br />减去；少掉；不足；<br />n.<br />较少，较小；
-like	做词根时的意思：<br />表形容词,“像…一样”<br />eg：<br />warlike<br />好战的；尚武的；军事的；与战争有关的；<br />vicelike<br />紧紧的，牢牢的，逃不了的；<br />childlike<br />孩子般的；天真的；	***************<br />做单词时的意思：<br />vt.<br />喜欢；（与 would 或 should 连用表示客气）想；想要<br />prep.<br />（表示属性）像；（表示方式）如同；（询问意见）…怎么样；（表示列<br />adj.<br />相似的；相同的；<br />n.<br />相类似的人[事物]；喜好；爱好；（尤指被视为没有某人或某物那么好<br />conj.<br />像…一样；如同；好像；仿佛；<br />adv.<br />（非正式口语，代替 as）和…一样；如；（非正式口语，思考说下句
-ling	做词根时的意思：<br />表名词，“小东西或某种人”<br />eg：<br />duckling<br />小鸭，幼鸭；丑小鸭（初似平庸后来出众的人或事物）；<br />seedling<br />秧苗，幼苗；树苗；实生苗；<br />sapling<br />幼树，树苗；	***************<br />做单词时的意思：<br />n.<br />鳕鱼；
-ly	做词根时的意思：<br />表形容词，通常加在名词后<br />eg：<br />spindly<br />（尤指腿）细长的，纤弱的；<br />timely<br />适时的；及时的；<br />comely<br /><文>英俊的，好看的；	***************<br />做单词时的意思：<br />abbr.<br />Libya 利比亚；
-most	做词根时的意思：<br />表形容词，“最…的”<br />eg：<br />nethermost<br />最下面的；<br />innermost<br />最深处的；隐私的，最隐秘的；<br />headmost<br />最先的；	***************<br />做单词时的意思：<br />adv.<br />最，最多（大）；much的最高级；非常，很；几乎；<br />adj.<br />many的最高级；最多的，最大的；大概的；大多数的，大部分的；<br />n.<br />最大限度；大部分；大多数人；
-ness	做词根时的意思：<br />表名词，“性质，状态，”通常加在形容词后面<br />eg：<br />positiveness<br />肯定；确实；确信；积极性；<br />forwardness<br />提早；提前；鲁莽；冒失；<br />promptness<br />敏捷，迅速，机敏；	***************<br />做单词时的意思：<br />n.<br />海岬，海角；
-o	做词根时的意思：<br />表名词，“人，物或状态”<br />eg：<br />tyro<br />初学者，新手，生手；<br />maestro<br /><意>音乐大师（尤指名指挥）；艺术大师；乐队指挥；（球队等的）领<br />impresario<br />（演出的）主办人，经理；	***************<br />做单词时的意思：<br />n.<br />英语字母表的第15个字母；
-on	做词根时的意思：<br />表名词，指人，物和一些物理学上的名词<br />eg：<br />mason<br />石匠，泥瓦匠；共济会会员；梅森（人名）；  用砖瓦砌成；<br />baron<br />男爵；大亨，巨头；贵族；脊肉；<br />patron<br />赞助人，资助人；顾客，老主顾；保护人；[宗]守护神；	***************<br />做单词时的意思：<br />prep.<br />（表示方向）向；（表示对象）对；（表示位置）在…上；（表示时间）<br />adv.<br />（放，穿，连接）上；向前，（继续）下去；<br />adj.<br />活动着的情况，状态；使用着的；发生着的；计划中的；
-oon	做词根时的意思：<br />表名词，“人或物”<br />eg：<br />tycoon<br /><日><史>大君；将军；<口>企业巨头；大亨；<br />buffoon<br />愚蠢的人；傻瓜；逗乐小丑；滑稽的人；<br />poltroon<br />胆小鬼，懦夫；	***************<br />做单词时的意思：<br />abbr.<br />optical overlay network 光重叠网络；
-or	做词根时的意思：<br />表名词，“人或物器”，在一些词根前写成“－ator”<br />eg：<br />mentor<br />（无经验之人的）有经验可信赖的顾问；  做…的良师；指导；<br />vendor<br />摊贩，小贩；卖主；[贸易]自动售货机；<正式>供应商；<br />precursor<br />前辈，前驱，先锋，前任；预兆，先兆，初期形式；[核]前驱波，初级	***************<br />做单词时的意思：<br />conj.<br />或，或者；还是；不然，否则；左右；<br />prep.<br /><古、诗>在…之前，比…更早；<br />n.<br />[纹章]黑金色、黑色；
-ory	做词根时的意思：<br />表形容词，“…的”<br />eg：<br />compulsory<br />必须做的，强制性的；义务的；必修的；<br />illusory<br /><正>貌似真实的，虚幻的；虚无缥缈；<br />obligatory<br />必须的；应尽的；义务的；强制性的；	***************<br />做单词时的意思：<br />阿诺德认知评鉴学说；<br />0<br />阿诺德认知评鉴学说；
-ose	做词根时的意思：<br />表形容词，“多…的”<br />eg：<br />verbose<br />冗长的，啰唆的，累赘的；  冗长地，啰唆地，累赘地；<br />bellicose<br /><正>好战的，好争吵的，好斗的；黩武；<br />grandiose<br />宏伟的；浮夸的；壮阔；沾沾自喜；	***************<br />做单词时的意思：<br />[医] 白金耳，接种环；
-osity	做词根时的意思：<br />表名词，ose + ity组成，表示“多…的状态”<br />eg：<br />curiosity<br />好奇心，爱打听的癖性；奇人；奇物，古玩；奇特性；<br />generosity<br />慷慨，大方；宽容或慷慨的行为；丰富；<br />animosity<br />憎恨，仇恨，敌意；	***************<br />做单词时的意思：
-ot	做词根时的意思：<br />表名词，“…人”<br />eg：<br />bigot<br />抱偏见的人，执拗的人，心胸狭窄的人；<br />idiot<br />傻瓜，笨蛋；白痴；<br />polyglot<br />（人）通晓、使用多种语言的，（书等）用多种语言写的；  通晓多种语言的人；	***************<br />做单词时的意思：<br />abbr.<br />ought to 应该；on time 准时；otology 耳
-ous	做词根时的意思：<br />表形容词，通常放在一个完整的单词后，表示“…的”<br />eg：<br />dangerous<br />危险的；<br />mountainous<br />多山的；巨大的；山一般的；<br />poisonous<br />有毒的；有害的；恶意的；<口>讨厌的；	***************<br />做单词时的意思：<br />abbr.<br />out of service 不工作的；未使用的；停工；停用；
-proof	做词根时的意思：<br />表形容词，“防…的”<br />eg：<br />waterproof<br />不透水的，防水的；用防水材料处理过的；  使防水，使不透水；给（布）上胶；  防水衣物，雨衣 usually plural；防水布，油布；防水<br />foolproof<br />（方法、计划、系统等设计得）万无一失的，肯定成功的；<br />rainproof<br />雨衣，雨披；  防水的；防雨的；  使防水；	***************<br />做单词时的意思：<br />n.<br />证明；校样；检验；（酒的）标准酒精度；<br />adj.<br />防…的；抗…的；能抵御；能防范；<br />vt.<br />给（织物）做防护处理，使防水（或防火等）；印…的校样；<br />vi.<br />[印刷术] 校对；发酵；
-ress	做词根时的意思：<br />表名词，指“女性”<br />eg：<br />actress<br />女演员；女表演者；<br />heiress<br />女继承人，嗣女；<br />seamstress<br />女裁缝，做针线活的妇女；	***************<br />做单词时的意思：<br />abbr.<br />Radar Echo-Simulation Study 雷达回波
-ry	做词根时的意思：<br />表名词，“状态，性质”<br />eg：<br />rivalry<br />竞争，对抗，对立；竞争行为，对抗行为；<br />mimicry<br />模仿，模仿的技巧；<br />artistry<br />艺术之性质；技艺；	***************<br />做单词时的意思：<br />abbr.<br />relay 转运；补充；接替；rydberg 雷得堡；
-ship	做词根时的意思：<br />表示某种关系或状态<br />eg：<br />hardship<br />艰难；困苦；艰难情况；造成困苦与苦难的原因；<br />citizenship<br />公民身份；公民权；<br />friendship<br />友情，友谊；友善的关系；友善，好意；	***************<br />做单词时的意思：<br />n.<br />船；<口>宇宙飞船；（舰船上的）全体船员；运气；<br />vt.& vi.<br />运送；<br />vt.<br />把…装上船；装好（船具）；上市；使乘船；<br />vi.<br />在船上工作；乘船旅行；当船员；
-some	做词根时的意思：<br />表形容词，“充满…的，具有…倾向的”<br />eg：<br />frolicsome<br /><主文>爱闹着玩的，嬉戏的；<br />meddlesome<br />好干预的，爱管闲事的；<br />mettlesome<br /><褒>（通常指马等）精力充沛的，勇猛的；	***************<br />做单词时的意思：<br />adj.<br />一些；某个；大约；相当多的；<br />pron.<br />一些；若干；其中的一部分；（数量不确切时用）有些人；<br />adv.<br />非常；相当；<美>稍微；
-ster	做词根时的意思：<br />表名词，“…人”<br />eg：<br />huckster<br />大声叫卖的小贩；大吹大擂的推销商；  讨价还价，没完没了地争论；叫卖（货物）；<br />pollster<br />民意调查（分析）者；整理民意测验结果的人；<br />prankster<br />顽皮的人，爱开玩笑的人；	***************<br />做单词时的意思：<br />abbr.<br />sterilization 消毒；sterilize 消毒；st<br />13<br />sterilization 消毒；sterilize 消毒；st
-th	做词根时的意思：<br />表名词，通常指抽象名词<br />eg：<br />warmth<br />温暖，暖和；热情，热心；激动；诚恳；<br />growth<br />生长；增长；一茬植株；肿块，肿瘤；<br />stealth<br />秘密行动；鬼祟；隐形，潜入；	***************<br />做单词时的意思：<br />abbr.<br />Thailand 泰国；
-tic	做词根时的意思：<br />表形容词，通常放在一个名词前，“与…相关的，…的”<br />eg：<br />chaotic<br />混沌的；一片混乱的；一团糟的；无秩序的；<br />aromatic<br />芳香的，有香味的；[化]芳香族的；  芳香植物；芳香剂，香料；<br />dramatic<br />戏剧的，戏剧性的；引人注目的；激动人心的；	***************<br />做单词时的意思：<br />n.<br />（尤指面部或头部肌肉的）抽搐，痉挛；
-tion	做词根时的意思：<br />名词后缀<br />eg：<br />action<br />行动，活动；功能，作用；手段；[法]诉讼；<br />education<br />教育；教育学；培养；训练；<br />explanation<br />解释；说明；辩解；（消除误会后）和解；	***************<br />做单词时的意思：<br />支票电托收，象征式互动；
-ture	做词根时的意思：<br />表名词，通常在单词或词根以t结尾时使用，表示“一般状态，行为”…<br />eg：<br />miniature<br />小型的，微小的；  微型复制品；微小模型；微型画；微型人像画；  使成小型；把…画成纤细画；缩写；<br />legislature<br />立法机关；立法机构；立法部；（特指）州议会；<br />fracture<br />（使）折断，破碎；  破裂，断裂；骨折；	***************<br />做单词时的意思：<br />油温测量装置；介观结构；
-ty	做词根时的意思：<br />表名词，用在形容词后，把形容词变成名词<br />eg：<br />safety<br />安全；安全性；安全处所；中卫；  保障安全的；<br />entirety<br />整体，全面；作为一个整体；完全；<br />certainty<br />确定性，确实性；确定的事，必然的事；	***************<br />做单词时的意思：<br />abbr.<br />thank you 谢谢你；type 类型；today 今天；t
-ular	做词根时的意思：<br />表形容词，“有…形状或性质的”<br />eg：<br />spectacular<br />场面富丽的，壮观的；引人注意的；惊动一时的；惊人的；  壮观的场面，精彩的表演；〈美〉一小时半以上的大场面电视节目；特大<br />ac<br /><拉>饭前（服）；<br />vascular<br />脉管的；血管的；含有血管的；充满活力的；	***************<br />做单词时的意思：
-ule	做词根时的意思：<br />表名词，“小…”<br />eg：<br />granule<br />小颗粒，小硬粒；<br />plumule<br />胚芽，胚茎；（小鸟的）绒羽；幼芽；<br />globule<br />小球，水珠；	***************<br />做单词时的意思：<br />[医][牙]龈；<br />0<br />[医][牙]龈；
-uous	做词根时的意思：<br />表形容词，“多…的”<br />eg：<br />vacuous<br />空虚的；愚蠢的；茫然若失的；无聊的；  无意义地，茫然若失地，无所事事地；  空虚，无聊，愚蠢；<br />innocuous<br />无害的；平淡无味的；<br />promiscuous<br />（尤指）性关系随便的；混杂的；随便的；淫乱；	***************<br />做单词时的意思：
-ward	做词根时的意思：<br />表形容词 + 副词，“向…”<br />eg：<br />leeward<br />背风的（地），下风的（地）；  下风；<br />backward<br />向后的；反向的；怯生生的；落后的；  向后地；相反地；回溯地；<br />ward<br />病房，病室；监视，监督；保卫；[法]受监护人；  监护，守护；挡住，架住；避开；收容；	***************<br />做单词时的意思：<br />n.<br />病房，病室；监视，监督；保卫；[法]受监护人；<br />vt.<br />监护，守护；挡住，架住；避开；收容；
-wise	做词根时的意思：<br />表副词，“方向，状态”<br />eg：<br />clockwise<br />顺时针方向的；右旋的；正转的；  顺时针方向转动地；右旋地；正转地；<br />likewise<br />同样地；也，而且；<br />otherwise<br />否则；另外；别的方式；  别的，另外的；不同的；  否则，不然；	***************<br />做单词时的意思：<br />adj.<br />聪明的，有智慧的；博学的，博识的；明白的；像智者的；<br />vt.<br />使知道，使懂得；教导；指点；<br />vi.<br />了解，知道；
-y	做词根时的意思：<br />表形容词，加在名词后变成形容词<br />eg：<br />tardy<br />行动缓慢的； 缓缓移动的；晚的； 迟的；<br />windy<br />有风的；腹胀的；吹牛的；空谈的；<br />hilly<br />多丘陵的；多小山的；多坡的；峭峻的；	***************<br />做单词时的意思：<br />n.<br />英语字母表的第25个字母；
a-	做词根时的意思：<br />加在单词或词根前面，表示"不，无，非"<br />eg：<br />asocial<br />缺乏社交性的，自我中心的，自私的；<br />amoral<br />不属于道德范畴的；没有道德原则的；无道德感的；无从区分是非的；<br />apolitical<br />对政治不感兴趣的，与政治无关的；无政治意义的；	***************<br />做单词时的意思：<br />art.<br />一（个）；每一（个）；任一（个）；
ab-	做词根时的意思：<br />ab-,abs-加在词根前，表示"相反，变坏，离去"等<br />eg：<br />abuse<br />滥用；恶习；侮辱；恶言；  滥用；虐待；辱骂；<br />absorb<br />吸收（液体、气体等）；吸引（注意）；吞并，合并；忍受，承担（费用<br />absent<br />缺席的，不在场的；缺少的，缺乏的；不在意的，茫然的；  缺席，不参加；不在；	***************<br />做单词时的意思：<br />n.<br /><波斯>水，河； <拉>从，自；
abs-	做词根时的意思：<br />ab-,abs-加在词根前，表示"相反，变坏，离去"等<br />eg：<br />abstract<br />抽象的，理论上的；难解的；抽象派的；茫然的；  抽象概念；抽象派艺术作品；摘要；[化]萃取物；  提取，分离；转移（注意等）；概括，摘录；<婉辞>剽窃；<br />abstain<br />戒（尤指酒），戒除；弃权；避免；<br />abscond<br />（尤指逃避逮捕）潜逃，逃跑；  潜逃者；逃跑者；	***************<br />做单词时的意思：<br />abbr.<br />acrylonitrile-butadiene-styrene
acid	做词根时的意思：<br />sour, sharp,尖，酸，锐利<br />eg：<br />acid<br />酸味的；尖刻的；酸的；酸性的；  <化>酸；酸味物质；<br />acidity<br />酸性；<化>酸性；<医>胃酸过多；（言词等的）类刻；<br />acrid<br />辛辣的；刺鼻的；（性格、态度、言词等）刻薄的；尖刻的；	***************<br />做单词时的意思：<br />adj.<br />酸味的；尖刻的；酸的；酸性的；<br />n.<br /><化>酸；酸味物质；
acle	做词根时的意思：<br />表名词，…物品，状态<br />eg：<br />receptacle<br />容器，放置物品的地方；<br />manacle<br />手铐；  给…带上手铐；<br />miracle<br />奇迹，圣迹，神迹；令人惊奇的人（或事）；	***************<br />做单词时的意思：<br />n.<br />阿克来；
act	做词根时的意思：<br />to do, to drive,行动，做<br />eg：<br />act<br />行动；表现；表演；起作用；  行为；行动；法案，法令；短节目；<br />activity<br />活动；活跃，敏捷；活动力；教育活动；<br />activate<br />使活动，起动，触发；使开始作用；	***************<br />做单词时的意思：<br />v.<br />行动；表现；表演；起作用；<br />n.<br />行为；行动；法案，法令；短节目；
acu	做词根时的意思：<br />sour, sharp, 尖，酸，锐利<br />eg：<br />acute<br />尖的，锐的；敏锐的，敏感的；严重的，剧烈的；[医]急性的；<br />acuity<br />尖锐，（疾病的）剧烈，（视力、才智等的）敏锐；敏度；<br />acumen<br />敏锐； 聪明；<植>渐尖头；<动>短刺；	***************<br />做单词时的意思：<br />abbr.<br />acuity 敏锐；acupuncture 针刺疗法；acumi
ad-	做词根时的意思：<br />加在在单词或词根前，表示"做…，加强…"<br />eg：	***************<br />做单词时的意思：<br />n.<br />广告；网球中的优势分advantage. ad in；
aer	做词根时的意思：<br />air,空气，充气<br />eg：<br />aerate<br />使暴露于空气中，使充满气体；<br />aerial<br />空气的；航空的，空中的；空想的；  [电讯] 天线；<br />aeroview<br />空中俯瞰图；	***************<br />做单词时的意思：<br />n.<br />气压单位；
ag-	做词根时的意思：<br />do,act,做，动<br />eg：<br />agent<br />代理人；代理商；药剂；特工；  由…作中介；由…代理；  代理的；<br />agenda<br />议事日程；待议诸事项一览表；日常工作事项；议程（ agendum<br />agile<br />灵巧的；轻快的；灵活的；机敏的；	***************<br />做单词时的意思：<br />adj.<br />农业的；
agog	做词根时的意思：<br />lead，引导<br />eg：<br />demagogue<br />煽动者，蛊惑民心的政客；	***************<br />做单词时的意思：<br />adj.& adv.<br />渴望的（地）；期待着的（地）；极兴奋的（地）；激动的（地）；<br />adj.<br />焦急地期待着；
agon	做词根时的意思：<br />struggle，挣扎，斗争<br />eg：<br />agony<br />极大的痛苦；苦恼，烦闷；临死的挣扎；（感情的）迸发；<br />antagonize<br />使成为敌人；引起…敌对[对抗]；对…起反作用；中和；<br />antagonist<br />敌手，反对者；<解>对抗肌，拮抗肌；<药>对抗药；（戏剧，小说等	***************<br />做单词时的意思：<br />n.<br />斗争，有奖竞赛；
agr-	做词根时的意思：<br />field,农田<br />eg：<br />agrarian<br />土地的；农业的；农村的；促进农业利益的；  平均地权论者；<br />agronomy<br />农艺学，农学；<br />agrobiology<br />土壤生物学，农业生物学；	***************<br />做单词时的意思：<br />abbr.<br />agriculture 农业；agricultural 农业的；
agri-	做词根时的意思：<br />field,田地，农田<br />eg：<br />agriculture<br />农业；农耕；农业生产；农学；<br />agrimotor<br />农耕用拖拉机；	***************<br />做单词时的意思：<br />abbr.<br />agriculture 农业；agricultural 农业的；
alb	做词根时的意思：<br />white，白色<br />eg：<br />albino<br />白化病者，白化变种；<br />album<br />相册；集邮簿；签名册；唱片；	***************<br />做单词时的意思：<br />n.<br />白麻布圣职衣；僧袍；
alg	做词根时的意思：<br />pain，痛<br />eg：<br />nostalgia<br />对往事的怀恋；怀旧；乡愁；怀乡病；<br />analgesic<br />止痛剂，镇痛剂；  止痛的，痛觉缺失的；<br />neuralgia<br /><医>神经痛；	***************<br />做单词时的意思：<br />abbr.<br />antilymphocyte globulin 抗淋巴球球蛋白(
ali	做词根时的意思：<br />其他的，外来的<br />eg：<br />alien<br />外国的；相异的；异已的；不相容的；  外国人；外侨；局外人；外星人；  让渡，转让；疏远；离间；<br />alienate<br />使疏远，离间；使转移，放弃；[法]转让，让渡（财产或权利）；	***************<br />做单词时的意思：<br />abbr.<br />(Arabic=high) （阿拉伯语）高的；高原的；air-l
alt	做词根时的意思：<br />high,高<br />eg：<br />altitude<br />高度，海拔高度；高位，高等；[天]地平纬度；[数]顶垂线；<br />exalted<br />高贵的；高尚的，崇高的；意气风发的；兴奋的，得意洋洋的；  赞扬( exalt的过去式和过去分词)，歌颂；提升，提拔；使激动<br />altar<br />祭坛，圣坛；圣餐台；	***************<br />做单词时的意思：<br />n.& adj.<br />高音（的）；<br />n.<br />= Accelerated Life Testing 加速寿命试
alter	做词根时的意思：<br />other, to change, 其他的，改变状态<br />eg：<br />alter<br />改变；更改；改建（房屋）；（人）变老；  改变；修改；<br />alteration<br />变化，改变；变更；<br />alternation<br />交替，轮流，间隔；交替工作；更迭；变换；	***************<br />做单词时的意思：<br />vt.<br />改变；更改；改建（房屋）；（人）变老；<br />vi.<br />改变；修改；
am	做词根时的意思：<br />love,爱，情爱<br />eg：<br />amiable<br />和蔼可亲的；温和的；<br />amicable<br />友好的，温和的；和睦的；友善的；<br />amity<br />和睦，友好关系；	***************<br />做单词时的意思：<br />abbr.<br />(=amplitude modulation) <无>调频，调谐<br />vi.<br />（用于第一人称单数现在时）是；<br />aux.<br />（与v-ing连用构成现在进行时，与v-ed连用构成被动语态）；
ambul	做词根时的意思：<br />walk,行走，走路<br />eg：<br />ambulance<br />救护车；野战医院；<br />perambulate<br />穿过；走过；徘徊于；巡行；<br />somnambulate<br />梦游；	***************<br />做单词时的意思：<br />abbr.<br />ambulation 移动；ambulating 走动的；amb<br />13<br />ambulation 移动；ambulating 走动的；amb
amphi-	做词根时的意思：<br />两个，两种<br />eg：<br />amphibian<br />两栖动物；水陆两用车；水旱两生植物；水陆两用飞行器；  两栖（类）的；水陆两用的；具有双重性格的；<br />amphicar<br />水陆两用车；	***************<br />做单词时的意思：<br />abbr.<br />(Greek prefix=both, both sides o<br />13<br />(Greek prefix=both, both sides o
ampl	做词根时的意思：<br />take,procure,拿，获得<br />eg：<br />ample<br />足够的；充足的，丰富的；宽敞的，广大的；富裕的；<br />sample<br />样品，华样；标本，榜样；（化验的）取样；[信]信号瞬时值；  取…的样品，尤指用样品来检验；品尝；抽样调查；  作为代表或范例的；<br />example<br />例子；榜样；范例；先例；  作为…的例子；为…做出榜样；  举例；作为…的示范；	***************<br />做单词时的意思：<br />abbr.<br />a macroprogramming language 一种可编<br />13<br />a macroprogramming language 一种可编
an-	做词根时的意思：<br />不，无<br />eg：<br />anarchism<br />无政府主义；无法无天，反政府的恐怖活动；<br />anharmonic<br />不和谐的，不调和的；<br />anechoic<br />无回声的，无反响的；	***************<br />做单词时的意思：<br />art.<br />一（在元音字母前代替不定代词a）；一任一某一；一个；
ana-	做词根时的意思：<br />分开<br />eg：<br />analysis<br />分析，分解；梗概，要略；[数]解析；验定；<br />analogy<br />类似，相似；比拟，类比；类推；<br />analogous<br />相似的，可比拟的；<生>同功的；模拟式；	***************<br />做单词时的意思：<br />n.<br />（关于某人的）轶事；闲话；文坛杂闻；语录；
anci	做词根时的意思：<br />old，古老<br />eg：<br />ancient<br />古代的，已往的；古老的，过时的；年老的；老式的；  古代人；古文明国的国民；<古>高龄老人；<古>旗手；<br />ancientry<br />古风，古代，古旧；	***************<br />做单词时的意思：
andro	做词根时的意思：<br />男，男人<br />eg：<br />androgyne<br />两性人，阴阳人；女化男子；<br />androgynism<br />女性假两性同体；<br />polyandry<br />一妻多夫（制）；一妻多夫制；多雄性；一雌多雄；	***************<br />做单词时的意思：<br />abbr.<br />(Greek prefix=old) （希腊语前缀）老的；and
anim	做词根时的意思：<br />life,spirit,心灵，精神，生命<br />eg：<br />animal<br />动物，兽，牲畜；<俚>家畜，牲口；<俚>畜生（一般的人）；兽性； 动物的；肉体的；肉欲的；<br />animate<br />使有生气；驱动；使栩栩如生地动作；赋予…以生命；  有生命的；活的；有生气的；生气勃勃的；<br />inanimate<br />无生命的；无生气的； 无精打采的； 单调的；	***************<br />做单词时的意思：<br />abbr.<br />animal 动物；animato (Italian=anima
ann	做词根时的意思：<br />year,年<br />eg：<br />annual<br />每年的；一年的；[植物]一年生的；  年刊；一年生植物；<br />anniversary<br />周年纪念日；  周年的；周年纪念的；年年的；每年的；<br />annuity<br />年金；养老金；年金享受权；年金保险投资；	***************<br />做单词时的意思：<br />abbr.<br />annonce (Dano-Norwegian=advertis
ante-	做词根时的意思：<br />前面，先<br />eg：<br />antedate<br />（在历史上）比…为早；先于；早于；（在信、支票等上）填写比实际日<br />anterior<br />位于前部的；先前的；早期的；（逻辑上）在前的；<br />antecedent<br />经历；<数>（比例）前项；<逻>前件；祖先；  在前的，在先的，先行的；	***************<br />做单词时的意思：<br />n.<br />（赌纸牌下的）赌注；已付的金额；分担额；预付款；<br />vt.& vi.<br />（尤指赌账）付账；付出；支付分担额；付款（通常指不愿意的）；
anthrop	做词根时的意思：<br /><br />eg：	***************<br />做单词时的意思：<br />n.<br />人类学；
anthropo	做词根时的意思：<br />man,human,人类<br />eg：<br />anthropology<br />人类学；<br />anthropologist<br />人类学家；<br />anthropogeography<br />人文地理分布学；	***************<br />做单词时的意思：
anti-	做词根时的意思：<br />反对，相反<br />eg：<br />antipathy<br />反感；引起反感的事物；憎恶的对象；<古>（在本性、倾向等方面的）<br />antithesis<br />对立；对立面；对照；对偶；<br />antibody<br /><医>抗体；	***************<br />做单词时的意思：<br />n.& adj.<br />反对者，反对论者反对的；
antiq	做词根时的意思：<br />old，古老<br />eg：<br />antique<br />古老的，古代的；过时的，古董的；古时制造的；古风的；  古玩，古董；古风，古希腊和古罗马艺术风格；  仿古制作；使显得古色古香；寻觅古玩；<br />antiquated<br />过时的，陈旧的；老式的，古色古香的；有古风的；年老的；  使古旧，废弃（antiquate的过去式和过去分词）；<br />antiquity<br />古老，古代；古迹，古物；古人；古代的风俗习惯；	***************<br />做单词时的意思：<br />abbr.<br />antiquarian 古文物研究者；收集古文物者；antiqu<br />13<br />antiquarian 古文物研究者；收集古文物者；antiqu
apt	做词根时的意思：<br />fit, ability,适应，能力<br />eg：<br />apt<br />恰当的，适当的；有…倾向的；易于…的；聪明的，灵巧的；  (=automatically programmed tool)<br />aptitude<br />（学习方面的）才能，资质，天资；适合性；倾向；<br />adapt<br />适应于，适应不同情况（或环境）(to)；  改编，改写；改变…以适合(for)；	***************<br />做单词时的意思：<br />adj.<br />恰当的，适当的；有…倾向的；易于…的；聪明的，灵巧的；<br />abbr.<br />(=automatically programmed tool)
aqu	做词根时的意思：<br />water,水<br />eg：<br />aquatic<br />水生的；水产的；水上的；水中（进行）的；  水生动植物；水上运动；<br />opaque<br />不透明的；无光泽的，晦暗的；不传导性的；含糊的，迟钝的；  不透明，晦暗；[建]遮檐；遮光涂料；	***************<br />做单词时的意思：<br />abbr.<br />aqueous 水的，含水的；
aqua	做词根时的意思：<br />water,水<br />eg：<br />aquarium<br />水族馆；水族槽，养鱼缸；玻璃鱼池；<br />subaquatic<br />半水生的；	***************<br />做单词时的意思：<br />n.<br />浅绿色，水绿色；
arc	做词根时的意思：<br /><br />eg：	***************<br />做单词时的意思：<br />n.<br />综合症状；弧（度）；天穹；电弧，弧光。；<br />vi.<br />形成拱状物；循弧线行进；<br />abbr.<br />American Red Cross. 美国红十字会；
arch	做词根时的意思：<br />ruler, rule, chief, 统治者，统治，主要的<br />eg：<br />anarchy<br />混乱；无秩序；无政府状态；<br />anarchism<br />无政府主义；无法无天，反政府的恐怖活动；<br />architect<br />建筑师，设计师；创造者，缔造者；造物主；	***************<br />做单词时的意思：<br />n.<br />弓形；拱门；拱形物；足弓，齿弓；<br />vt.<br />（使）弯成拱形；用拱连接；向后弯；<br />vi.<br />拱起；成为弓形；<br />adj.<br />主要的；首要的；调皮的；淘气的；
arm	做词根时的意思：<br />weapon，武器<br />eg：<br />armada<br />舰队；大队（行进的东西）；(16世纪西班牙的)无敌舰队；（飞机）<br />armistice<br />停火； 停战；休战协议；停战协议；<br />armor<br />装甲；盔甲；保障；装甲部队；  为…穿盔甲（或加置装甲）；为…提供防御；	***************<br />做单词时的意思：<br />n.<br />臂；武器；[复数]战事；权力；<br />vi.<br />准备（斗争），准备行动（against）；<br />vt.<br />装备（防御工事）；准备（攻击或迎击）；配备；防护；
art	做词根时的意思：<br />skill, joint, trick, 技巧，关节，诡计<br />eg：<br />article<br />（报章杂志中的）文章，论文；条款；物品；[语] 冠词；  使受协议条款的约束；以协议（或契约）约束；订约将…收为学徒（或徒 进行控告，提出罪状（或指责）(against)；签订协议；<br />artistry<br />艺术之性质；技艺；<br />artificial<br />人造的；人工的；虚假的，非原产地的；人为的；  人造肥料；<美>假花；	***************<br />做单词时的意思：<br />n.<br />艺术；艺术作品；（需要技术、工艺的）行业；文艺（包括绘画、雕塑、<br />vi.<br />thou art 即 you are,对一人讲话时用；<br />adj.<br />艺术的；（为）艺术家的；艺术品的；具有艺术性的；<br />vt.& vi.<br />[口语]（把…）装饰得古色古香，（把…）装饰得古怪而有艺术趣味，
aster	做词根时的意思：<br />star,星星<br />eg：<br />disaster<br />灾难；彻底的失败；不幸；祸患；	***************<br />做单词时的意思：<br />n.<br />紫菀属植物；天体；碎件；星体；
astro	做词根时的意思：<br />star,星星<br />eg：<br />astronaut<br />宇航员；太空人；航天员；<br />astral<br />星形的；星际的；<br />astrophysics<br />天体物理学；	***************<br />做单词时的意思：<br />abbr.<br />astronomer 天文学家；astronomy 天文学；as
audi	做词根时的意思：<br />hear,听<br />eg：<br />audience<br />观众；读者；接见；听众；<br />audible<br />听得见的；<br />auditorium<br />观众席，听众席；礼堂，会堂；	***************<br />做单词时的意思：<br />n.<br />（汽车品牌）奥迪；
aug	做词根时的意思：<br />increase，增加<br />eg：<br />augment<br />增强，加强；增加，增添；（使）扩张，扩大；  增加，补充物；<br />auction<br />拍卖；竞卖；标售；（桥牌）拍卖玩法；  拍卖；竞卖；<br />august<br />令人敬畏的，威严的；	***************<br />做单词时的意思：<br />abbr.<br />augment 增加，增大；augmentation 增大[加，
avi	做词根时的意思：<br />desire,bird,渴望，鸟<br />eg：<br />avid<br />渴望的；贪婪的；热心的；<br />aviary<br />大鸟笼，鸟舍；鸟类饲养场；<br />aviation<br />航空；飞行术，航空学；飞机制造业；[集合词]飞机；	***************<br />做单词时的意思：<br />abbr.<br />Video for windows的多媒体文件格式；
balm	做词根时的意思：<br />balsam，香油<br />eg：<br />balm<br />香油，香脂；芳香，香味；镇痛软膏；[植]白壳杨；  安抚，安慰；止痛；在…上搽香油；<br />balmy<br />（指空气）暖和的；温暖的；芳香的；能止痛的；<br />embalm<br />保存（尸体）不腐；使不被遗忘；使充满香气；	***************<br />做单词时的意思：<br />n.<br />香油，香脂；芳香，香味；镇痛软膏；[植]白壳杨；<br />v.<br />安抚，安慰；止痛；在…上搽香油；
ban	做词根时的意思：<br />prohibit，禁止<br />eg：<br />banal<br />陈腐的；平庸的；<br />banish<br />放逐，驱逐；消除，排除；<br />abandon<br />放弃，抛弃；离弃，丢弃；使屈从；停止进行，终止；  放任，放纵；完全屈从于压制；	***************<br />做单词时的意思：<br />vt.<br />禁止，下令禁止；剥夺权利；[古]诅咒；<br />n.<br />禁止，禁令；谴责；诅咒，诅骂；革出教门；
bar	做词根时的意思：<br />weight,重，压<br />eg：<br />barometer<br />气压计；晴雨表；显示变化的事物；<比喻>（舆论等的）标记；<br />baritone<br />男中音，男中音歌手；上低音部；上低音乐器；<br />baric<br />含钡的，钡的，气压的；	***************<br />做单词时的意思：<br />n.<br />条，棒；（门、窗等的）闩；障碍；酒吧间；<br />vt.<br />闩（门等）；阻碍，封锁；排除，去除；<br />prep.<br />除…之外；
barr	做词根时的意思：<br />stick,捧，栏<br />eg：<br />barrage<br />拦河坝；阻塞；弹幕；齐射式攻击；  以密集火力攻击（或阻击）；<br />barricade<br />路障，障碍物；防御，阻碍；  设路障于，以障碍物阻塞；封锁，阻挡；<br />barrier<br />障碍；屏障；栅栏；分界线；  把…关入栅栏；用栅栏围住；	***************<br />做单词时的意思：<br />abbr.<br />barrister （出庭）律师，<美国>律师；
bas	做词根时的意思：<br />low, foundation,低下，基础<br />eg：<br />base<br />基础；基地；根据；基数（如十进制的10 和二进制的2）；  基于；把…建立在；把…放在或设在（基地）；把…置于底座（或基座） 卑鄙的；低级的；贱的，劣的；庶生的；<br />basement<br />地下室；[建]基底，底部；<br />abase<br />使谦卑；使感到羞耻；使降低（地位、身份等）；<古>降下；  贬低；屈辱；贬低别人的人；	***************<br />做单词时的意思：<br />abbr.<br />basilica 王宫；bass (or basso) 男低音；
bat	做词根时的意思：<br />beat，打，击<br />eg：<br />abate<br />减少，减轻；[法]取消法令，作废；  减轻；失效；  减轻；折扣；<br />debate<br />讨论；辩论；争论；辩论；  辩论；仔细考虑；思考；盘算；<br />rebate<br />折扣；回扣；  减少；打折；	***************<br />做单词时的意思：<br />n.<br />蝙蝠；短棍，（棒球等的）球棒，（网球等的）球拍；白话，口语，成语<br />vt.& vi.<br />用球板击球，用球棒击球（尤指板球或棒球运动）；
bel	做词根时的意思：<br />war, fight,战争，打斗<br />eg：<br />rebellion<br />造反，叛乱；反抗；<br />rebel<br />反政府的人；反叛者；造反者；叛逆者；  反抗的；造反的；  反抗政府；反抗权威；<br />rebellious<br />反叛的；造反的；难控制的；	***************<br />做单词时的意思：<br />n.<br />贝尔（音量比率的单位）；
bene	做词根时的意思：<br />善，好<br />eg：<br />benefit<br />利益，好处；救济金，津贴；义演，义卖；恩惠，恩泽；  有益于，有助于；使受益；得益，受益；<br />benediction<br />祝福；（礼拜结束时的）赐福祈祷；恩赐；（大写）（罗马天主教）祈求<br />benefaction<br />善行； 善举；赠品； 捐赠；	***************<br />做单词时的意思：<br />n.<br />祈祷，祷告；佳适；
bi	做词根时的意思：<br />两，两个<br />eg：<br />bilingual<br />双语的，两种语言的，能说两种语言的；  能说两种语言的人；<br />biennial<br />（事件）两年一次的；  两年生植物；<br />biweekly<br />两周一次的；  两周一次地；  双周刊；	***************<br />做单词时的意思：<br />n.<br />Burundi,布隆迪；公共汽车，巴士( bus的名词复数 )；
biblio	做词根时的意思：<br />book，书<br />eg：<br />bibliography<br />书目提要，书目；书志学，书志；文献，文献学；<br />bibliophile<br />爱书者，藏书家；<br />Bible<br />圣经；有权威的书；	***************<br />做单词时的意思：<br />n.<br />书志目录；
bili	做词根时的意思：<br />able，能力<br />eg：<br />ability<br />能力，资格；能耐，才能；<br />rehabilitate<br />使康复；使复原，修复；使恢复原状；使恢复名誉；<br />debilitate<br />使虚弱；使衰弱；	***************<br />做单词时的意思：<br />abbr.<br />bilirubin 胆红素；
bio	做词根时的意思：<br />life,生命<br />eg：<br />bionics<br /><美>仿生学；<br />biography<br />传记；档案；传记体文学；个人简介；<br />autobiography<br />自传；自传文学；	***************<br />做单词时的意思：<br />n.<br />（尤其供公开发表的）个人简历(biography的缩写)；
bol	做词根时的意思：<br />throw,抛<br />eg：<br />symbolize<br />象征；用符号表现；  使用符号；采用象征；作为…的象征；<br />symbol<br />象征；标志；符号；记号；  用符号代表；	***************<br />做单词时的意思：<br />abbr.<br />bill(s) of lading 提（货）单；bollard(
brace	做词根时的意思：<br />two arms,两臂<br />eg：<br />bracelet<br />手镯；手铐；<br />embrace<br />拥抱；  包括；包含；接受；信奉；  拥抱，怀抱；	***************<br />做单词时的意思：<br />vt.<br />支撑；系紧；准备，预备；振作起来；<br />vi.<br />准备好；支持；打起精神；<br />n.<br />支持物；铁钳，夹子；[语]大括号；绷紧（身体部位的）肌肉；
braid	做词根时的意思：<br />twist，扭<br />eg：<br />upbraid<br />责备，申斥，谴责；<br />embroidery<br />刺绣；刺绣品；粉饰，修饰；	***************<br />做单词时的意思：<br />n.<br />发辫；辫子；穗带；编织物；<br />vt.<br />把（头发）编成辫子；把…打缏子；（用饰带等）镶缀；编织；
brev	做词根时的意思：<br />short,短，缩短<br />eg：<br />abbreviate<br />使简短；缩简；缩略；使用缩写词；  使用缩写词的人；缩短，缩写（词、短语、名字、名称）；<br />abbreviation<br />省略，缩写，简化，缩写词，略语；[数学]约分；[音乐]略号；<br />brevity<br />短暂；简洁；	***************<br />做单词时的意思：<br />abbr.<br />brevetto (Italian=patent) （意大利语）
bu	做词根时的意思：<br />ox，牛<br />eg：<br />bully<br />恐吓，威逼；盛气凌人，以强凌弱；  欺侮；  仗势欺人者，横行霸道者；暴徒；打手；情人；  第一流的，特好的；  好，妙（感叹词）；<br />bucolic<br />牧民生活的，田园风味的，乡村风味的；  牧歌；田园诗；农民；牧人；<br />bugle<br />号角；喇叭；筋骨草属植物；（装饰女服的）柱状玻璃小珠；  吹号；吹喇叭；  吹号集合；发出吼声；吹号表示（冲锋，撤退等）；	***************<br />做单词时的意思：<br />（日本长度单位）日分；
by	做词根时的意思：<br />在旁边，副的<br />eg：<br />byproduct<br />副产品；意外结果，副作用；<br />bypass<br />旁道，支路；迂回管道；[电]分路迂徊；[医]导管；  疏通；忽视；管道运输；<br />bywork<br />副业，业余活计；	***************<br />做单词时的意思：<br />prep.<br />在…旁边；表示方式；由于；经过；<br />adv.<br />经过；表示保留或保存时用；短暂拜访；
calc	做词根时的意思：<br />stone，石头<br />eg：<br />calculate<br />计算；估计；打算，计划；旨在；  预测，推测；<br />recalcitrant<br />倔强对抗的，拒不服从的；拗强；<br />calcium<br /><化>钙；	***************<br />做单词时的意思：<br />[计] 计算；
camp	做词根时的意思：<br />field,田野<br />eg：<br />campus<br />校园；校区；<br />campaign<br />运动；竞选运动；战役；季节性竞赛；  参加[发起]运动，参加竞选；参战，参加战役；作战；<br />encamp<br />扎营；	***************<br />做单词时的意思：<br />n.<br />营地，工地宿舍；阵营（指观点相同且与持不同观点者对立的集团）；兵<br />vt.& vi.<br />宿营，露营；<br />adj.<br />夸张的；（男子）女人腔的；陈腐可笑的；（男人或其举止）故意带女子<br />vi.<br />（尤指在假日）野营；借住；行动矫揉造作；搞同性恋；<br />vt.<br />使扎营（住宿）；使宿于营中；为…提供住处；临时安顿；
cand	做词根时的意思：<br />white,glow,白，发光<br />eg：<br />candid<br />率直的，坦白的；公正的；偷拍的；<br />candor<br />坦率；爽直；公正；公平；<br />candidate<br />报考者；申请求职者；攻读学位者；最后命运或结局如何已显然可见者；	***************<br />做单词时的意思：<br />[化] 萤石；
cant	做词根时的意思：<br />sing,唱<br />eg：<br />cant<br />倾斜；（下层社会的）黑话；斜面；言不由衷的话；  斜穿；使用黑话（或行话等）；说言不由衷的话；  使具有斜面；使倾斜；将…斜掷出去；猛扔；  黑话的；有斜面的；斜穿的；<br />recant<br />撤回（声明），放弃（信仰或主张）；	***************<br />做单词时的意思：<br />n.<br />倾斜；（下层社会的）黑话；斜面；言不由衷的话；<br />vi.<br />斜穿；使用黑话（或行话等）；说言不由衷的话；<br />vt.<br />使具有斜面；使倾斜；将…斜掷出去；猛扔；<br />adj.<br />黑话的；有斜面的；斜穿的；
cap	做词根时的意思：<br />head,头<br />eg：<br />capital<br />首都；资本；资源；大写字母；  极好的；死刑的；资本的；首都的；<br />captain<br />船长，机长；领袖，首领；上尉；（美国警察局的）副巡长；  当首领；统帅或指挥；<br />cape<br />斗篷； 披肩；海角； 岬；	***************<br />做单词时的意思：<br />n.<br />盖；帽子；军帽；求交运算；<br />vi.<br />脱帽致意；<br />vt.<br />覆盖；给…戴帽；<br />abbr.<br />Common Agricultural Policy （欧共体）
card	做词根时的意思：<br />心脏<br />eg：<br />cardiac<br />心脏（病）的；（胃的）贲门的；  心脏病患者；强心剂；	***************<br />做单词时的意思：<br />n.<br />卡片；纸牌；明信片；信用卡；<br />vt.<br />记于卡片上；
carn	做词根时的意思：<br />flesh,肉，肉欲<br />eg：<br />carnival<br />狂欢节；嘉年华；节日，联欢；<br />carnivorous<br />（动物）食肉的；肉食；<br />reincarnate<br />赋予新形体，使转世化身；  转世化身的；	***************<br />做单词时的意思：<br />n.<br />堆石标记；
cast	做词根时的意思：<br />pure，纯洁<br />eg：<br />caste<br />（印度社会中的）种姓；印度的世袭阶级；等级（制度）；<br />chaste<br />纯真的；（风格）简单的；没有经过性交的；（性生活）忠于配偶的；<br />castigate<br />严厉批评；惩戒；对…实施严厉的惩罚；矫正，修订；	***************<br />做单词时的意思：<br />vt.<br />铸造；投掷；投射；脱落，脱皮；<br />n.<br />铸型；演员表；轻微的斜视；投，掷骰；<br />vi.<br />掷，投；计算，加；
cata	做词根时的意思：<br />向下，相反，离开<br />eg：<br />cataclysm<br />（突然降临的）大灾难；<br />catalog<br />目录，目录册，目录簿；[美]大学概况一览；登记，记载；产品样本； 登记；为…编目；编目录；记载；  把…按目录分类；把…编目；<br />catastrophe<br />大灾难；惨败；悲剧的结局；地表突然而猛烈的变动，灾变；	***************<br />做单词时的意思：<br />[机] 渺位；依照；
cav	做词根时的意思：<br />hole，洞<br />eg：<br />cavity<br />腔，洞；蛀牙，龋洞；<br />cavern<br />大山洞；凹处；  挖空；置…于山洞中；<br />concave<br />凹面，成凹形；  凹的；  使成凹形；	***************<br />做单词时的意思：<br />abbr.<br />cavalier 骑士；cavity 洞；cavalry 骑兵；
ced	做词根时的意思：<br />go,行走，前进<br />eg：<br />cede<br />让给，割让；放弃；<br />accede<br />（正式）加入；答应；（通过财产的添附而）增加；开始任职；<br />antecedent<br />经历；<数>（比例）前项；<逻>前件；祖先；  在前的，在先的，先行的；	***************<br />做单词时的意思：<br />abbr.<br />capacitance electronic disc 电容电子
ceed	做词根时的意思：<br />go,行走，前进<br />eg：<br />proceed<br />进行；前进；（沿特定路线）行进；（尤指打断后）继续说；  收入，获利；<br />proceeds<br />（买卖等的）收入，收益；  进行( proceed的第三人称单数 )；前进；（沿特定路线）行<br />succeed<br />成功；继承；  继承，继任，继位；随…之后；	***************<br />做单词时的意思：<br />abbr.<br />创业教育发展中心；
celer	做词根时的意思：<br />quick,speed,快，速<br />eg：<br />celerity<br />迅速，敏捷；<br />accelerate<br />（使）加快，（使）增速；加速，催促；促进；速度增加；  加快，加速；<br />acceleration<br />加速；<物>加速度；加速升级；（优秀学生的）跳级；	***************<br />做单词时的意思：
cens	做词根时的意思：<br />judge，判断<br />eg：<br />censor<br />监察官，检查员；（牛津大学等的）学监；[心理]潜意识压抑力；[心 审查，检查；审查（书刊等）；检查（信件等）；删改；<br />censure<br />指责，谴责；责备；斥责；  指责；谴责；责备；批评；  谴责，责备；<br />census<br />人口普查，统计；人口财产调查；	***************<br />做单词时的意思：<br />abbr.<br />censor （书刊、邮电等的）审查员；检查员；censorsh<br />13<br />censor （书刊、邮电等的）审查员；检查员；censorsh
cent	做词根时的意思：<br />hundred,一百<br />eg：<br />centimeter<br />厘米；<br />percentage<br />百分比，百分率；比例，部分；[数]百分法；[商]手续费；<br />centipede<br />蜈蚣；	***************<br />做单词时的意思：<br />n.<br />分；一分钱的硬币；零钱；（作单位的）百；
centr	做词根时的意思：<br />中心<br />eg：<br />central<br />中央的，中心的；重要的，核心的；  电话总局；电话转接员；<br />centripetal<br />向心（力）的；<br />concentrate<br />专心于；注意；集中；聚集；  浓缩，（使）浓缩；[采矿]汰选；选矿，精选，富集；  凝缩，浓缩，提纯；  浓缩物；  集中起来的，经过浓缩的；	***************<br />做单词时的意思：
cept	做词根时的意思：<br />take,拿取<br />eg：<br />except<br />把…除外；不计；  除…外；  [口语]要不是；除非；除…以外；  反对，表示异议（与 to 或 against连用）；<br />exception<br />例外，除外；反对，批评；[法律]异议，反对；<br />exceptional<br />优越的；杰出的；例外的；独特的；  超常的学生；	***************<br />做单词时的意思：<br />abbr.<br />chemically enhanced primary trea
cern	做词根时的意思：<br />sure, separate,搞清，区别<br />eg：<br />concern<br />涉及，关系到；使关心，使担忧；参与；  关心；关系，有关；顾虑；公司或企业；<br />discern<br />看出；理解，了解；识别，辨别；  辨明，分清；<br />discernment<br /><褒>识别能力；洞察力；敏锐；精明；	***************<br />做单词时的意思：<br />abbr.<br />European laboratory for particle
cert	做词根时的意思：<br />sure, separate,搞清，区别<br />eg：<br />certain<br />某一；必然的；已确定的；  [动词用复数]某些；<br />ascertain<br />弄清，确定，查明；<br />certify<br />（尤指书面）证明；发证书给…；证明（某人）患有精神病；颁发（或授	***************<br />做单词时的意思：<br />n.<br />必然发生的事；确实的事情；计算机紧急反应小组；
cess	做词根时的意思：<br />go,行走，前进<br />eg：<br />excess<br />超过；超额量；多余量；放肆；  超重的，过量的，额外的；<br />excessive<br />过度的，极度的；过分的；过多的；过逾；<br />process<br />过程；工序；做事方法；工艺流程；  加工；处理；审阅；审核；  列队行进；  经过特殊加工（或处理）的；	***************<br />做单词时的意思：<br />n.<br />税，税率，<爱>运气；
char	做词根时的意思：<br />dear，可爱的<br />eg：<br />charity<br />慈善（行为）；施舍，捐助；慈善机关；仁爱，宽容；<br />charitable<br />仁慈的，慈善的；宽恕的，宽厚的；慷慨的；<br />cherish<br />珍爱；怀有；爱护；抚育；	***************<br />做单词时的意思：<br />vt.<br />把…烧成炭，把…烧焦；烧焦；<br />vi.<br />烧成炭，烧焦；<主英>做杂役女佣；<br />n.<br />碳；（尤指家庭的）杂务；<鱼>嘉鱼；茶（英式英语旧时用法）；
chor	做词根时的意思：<br />sing，dance，歌，舞<br />eg：<br />choreographer<br />编舞者；<br />choreography<br />编舞艺术；舞蹈编排；<br />choir<br />教堂的唱诗班；唱诗队；公开表演的合唱团；（教堂）唱经楼；	***************<br />做单词时的意思：<br />abbr.<br />choruses 合唱队；choral 合唱队的；choreog
chrom	做词根时的意思：<br />color，颜色<br />eg：<br />monochrome<br />单色画，单色照片，黑白照片；  单色的，黑白的；<br />chromatic<br />有颜色的，颜色鲜艳的；<br />chromosome<br /><生>染色体；	***************<br />做单词时的意思：<br />[医]色；<br />0<br />[医]色；
chron	做词根时的意思：<br />time,时间<br />eg：<br />chronic<br />慢性的；长期的；习惯性的；痼；<br />chronology<br />年代学；年表，（按时间排列的）大事记；<br />synchronize<br />使同步；使同时；  同时发生；共同行动；	***************<br />做单词时的意思：<br />时；
cid	做词根时的意思：<br />cut,kill,切开，杀<br />eg：<br />decide<br />决定；决心；解决；裁决；  决定；下决心；<br />insecticide<br />杀虫剂；<br />pesticide<br />杀虫剂，农药；	***************<br />做单词时的意思：<br />abbr.<br />cash in drawer 现金支付；chick infect
circ	做词根时的意思：<br />ring,circle,圆，环<br />eg：<br />circular<br />圆形的；环行的；迂回的，绕行的；供传阅的，流通的；  通知，通告；印制的广告，传单；<br />circulate<br />（使）循环；（使）流通；（使）流传；散布；  传送，传递，传阅；<br />circulation<br />流通，传播；血液循环；发行量；（某段时间的）社交活动；	***************<br />做单词时的意思：<br />[计] 广义圈；
circum	做词根时的意思：<br />环绕，周围<br />eg：<br />circumference<br />周围，圆周；胸围；<br />circumscribe<br />在…周围划线；划定…范围；限制；限定；<br />circumvent<br />围绕，包围；用计防止；避免；（用欺骗手段）陷害；	***************<br />做单词时的意思：<br />圆周，周边；
cit	做词根时的意思：<br />quote,call, 引用，唤起<br />eg：<br />cite<br />引用，引证；[法]传讯；表扬；[军事]传（或通）令嘉奖；  <口>例证，引文；<br />citation<br />引用；引证；引文；表扬；<br />excite<br />使兴奋；激发；刺激；使紧张不安；	***************<br />做单词时的意思：<br />n.<br />市民，便服，老百姓服装；
civ	做词根时的意思：<br />citizen，公民<br />eg：<br />civil<br />公民的，市民的；文明的，有礼貌的；民用的，国民间的；[法]民事的<br />civilian<br />平民，百姓；市民；文官；民法学者；  民用的；平民的；<br />civilization<br />文明，文化；开化，教化；修养；文明社会；	***************<br />做单词时的意思：<br />[医][=chilo irridescent virus]奇洛彩<br />0<br />[医][=chilo irridescent virus]奇洛彩
claim	做词根时的意思：<br />cry out, shout,呼喊，叫喊<br />eg：<br />claim<br />声称；断言；需要；索取；  提出要求；  （根据权利而提出的）要求；声称；断言；索赔；<br />clamor<br />喧哗声，喧闹；大声的要求或抗议；  喧哗，吵闹；大声地要求或抗议；<br />acclaim<br />称赞；赞扬；向…欢呼；向…喝彩；  公开赞扬；称誉；  热烈欢迎或赞同；	***************<br />做单词时的意思：<br />vt.<br />声称；断言；需要；索取；<br />vi.<br />提出要求；<br />n.<br />（根据权利而提出的）要求；声称；断言；索赔；
clar	做词根时的意思：<br />clear, 清楚，明白<br />eg：<br />clarify<br />使清楚，澄清；  （尤指通过加热使黄油）纯净；说明；使（头脑、神智等）清醒；  （液体）变得澄清；净化；变得清楚；<br />clarity<br />清楚，明晰；透明；明确；清晰度；<br />clarification<br />（液体的）澄清；净化；澄清法；（意义等的）澄清、说明；	***************<br />做单词时的意思：<br />abbr.<br />clarification 澄清；clarify 澄清；clar
clin	做词根时的意思：<br />lean,slope,倾斜，斜坡<br />eg：<br />decline<br />下降；（力量、健康、品格、权力、价值等的）衰退；下倾；（人、生命 辞谢，谢绝（邀请等）；  （道路、物体等）下倾；（太阳）落下；（在品格、价值上）降低；衰落 谢绝，婉拒；<br />declination<br />倾斜；下倾；赤纬；磁偏角；<br />incline<br />（使）倾斜，弄斜；（使）偏向，倾向于；（使）认为；点（头）（以示 斜坡；斜面；坡度；倾斜；	***************<br />做单词时的意思：<br />abbr.<br />clinic 门诊部；临床；clinical 临床的；clino
clud	做词根时的意思：<br />close,关闭<br />eg：<br />conclude<br />结束，终止；推断；议定；  得出结论；缔结；推断出；决定；  终了；作出决定或达成协议；<br />conclusive<br />决定性的；令人信服的；确凿的；消除怀疑的；<br />exclude<br />排除，不包括；排斥；驱除，赶出；	***************<br />做单词时的意思：
co	做词根时的意思：<br />共同(放在辅音前时通常双写)<br />eg：<br />cooperation<br />合作； 协作；协助；配合；<br />coagulate<br />凝固；使结块，使变稠；  [废语]凝固的，凝结的，凝聚的；<br />coalesce<br />联合，合并；	***************<br />做单词时的意思：<br />abbr.<br />Colombia 哥伦比亚；Cash Order 现付票；Cer
coct	做词根时的意思：<br />cook，煮，调配<br />eg：<br />concoct<br />调制；捏造；图谋，策划；<br />precocious<br />早熟的；较早具备某种能力的；较早显出的；（儿童）老气的；<br />precocity<br />早熟，早成；	***************<br />做单词时的意思：<br />[医][=coctio]（拉）煮沸；
cogn	做词根时的意思：<br />know,知道<br />eg：<br />cognizant<br />察知的，认识（某事物）的；<br />recognize<br />认出；识别；承认；  承认，确认；[法律]具结，立保证书；<br />precognition<br /><正>预知，早知，先知；	***************<br />做单词时的意思：<br />abbr.<br />cognomen （古罗马人的）姓，名字（尤指绰号）；<br />13<br />cognomen （古罗马人的）姓，名字（尤指绰号）；
com	做词根时的意思：<br />together,一起<br />eg：<br />combine<br />使结合；使化合；兼有；用联合收割机收割；  联合；联合收割机；联合集团；组合艺术品（由画，拼贴和构成派雕塑等<br />compassion<br />怜悯，同情；恻隐之心；<br />compatriot<br />同胞；同国人；  同国人的；同胞的；	***************<br />做单词时的意思：<br />abbr.<br />commerce 商业；committee 委员会；comedy
cond	做词根时的意思：<br />hide，藏<br />eg：<br />abscond<br />（尤指逃避逮捕）潜逃，逃跑；  潜逃者；逃跑者；<br />recondite<br />深奥的；晦涩的；高深；<br />condiment<br />调味品，佐料；	***************<br />做单词时的意思：<br />[医][=condenser]冷凝器，聚光器，电容器；
con	做词根时的意思：<br />共同，一起<br />eg：<br />concentric<br />同一中心的，同轴的；  同一中心地，同轴地；<br />contemporary<br />当代的，现代的；同时代的，同属一个时期的；  同代人；同辈人；同龄人；当代人；<br />conclude<br />结束，终止；推断；议定；  得出结论；缔结；推断出；决定；  终了；作出决定或达成协议；	***************<br />做单词时的意思：<br />n.<br />反对票，反对者；反对的论点，反对的理由；<br />vt.<br />精读，熟读；默记，谙记；<br />prep.<br />以…，用…；反对；<br />adj.<br />欺诈的，骗取信任的；<br />adv.<br />反面地，从反面；
contra	做词根时的意思：<br />反对，相反<br />eg：<br />contrary<br />相反的；违反的，反对的；对立的；顽固的，任性的；  对立或相反的事物；对立方；[逻]反对命题；  相反地，矛盾地；<br />contradict<br />反驳，驳斥；否认；与…矛盾，与…抵触；  反驳；否认；发生矛盾；<br />contravene<br />抵触，与…不相容；违反，违背；否定，反驳；	***************<br />做单词时的意思：<br />n.& adv.<br />反对（地），相反（地）；
cord	做词根时的意思：<br />heart,心脏，一致<br />eg：<br />cordial<br />热诚的；诚恳的；兴奋的；  补品；兴奋剂；甘露酒；<br />record<br />记录，记载；档案，履历；唱片；最高纪录；  记录，记载；标明；录音；  创纪录的；<br />concord<br />和谐，一致，和睦；	***************<br />做单词时的意思：<br />n.<br />（细）绳；灯心绒裤；<br />vt.<br />用绳子捆绑；堆积（柴薪）；
corn	做词根时的意思：<br />horn,角<br />eg：<br />unicorn<br />（传说中身体似马的）独角兽；<动>一角鲸；独角兽标记；<br />cornet<br />短号；（盛冰激凌的）圆锥形蛋卷；吹短号者；<br />cornucopia<br />丰饶角（象征丰饶的羊角，角内呈现满溢的鲜花、水果等）；	***************<br />做单词时的意思：<br />n.<br /><英>谷物；<美>玉米；鸡眼；
corp	做词根时的意思：<br />body,身体，团体<br />eg：<br />corps<br />兵团；特种部队；一群人，一组人；<br />corporation<br />公司；法人；社团，团体；〈口〉（凸出的）大肚子；<br />corporate<br />法人的，团体的，社团的；公司的，总体国家的；〈古〉团结的；共同的	***************<br />做单词时的意思：<br />abbr.<br />（Latin prefix=body） （拉丁语前缀）身体；主要
cosm	做词根时的意思：<br />world，世界，宇宙<br />eg：<br />cosmic<br />宇宙的；极广阔的；<br />cosmos<br />宇宙；一个有序的整体；大波斯菊；<br />cosmopolis<br /><美>国际都市（由来自许多不同国家的人居住的大城市）；	***************<br />做单词时的意思：<br />abbr.<br />cosmetics 化妆品；cosmetic 化妆用的；cosm
counter	做词根时的意思：<br />反对，相反<br />eg：<br />counteract<br />抵消；阻碍；中和；<br />counterbalance<br />对…起平衡作用，抵消；  抗衡 （力），平衡力；<br />countermand<br />取消（命令），撤回；	***************<br />做单词时的意思：<br />n.<br />柜台；对立面；计数器；（某些棋盘游戏的）筹码；<br />adj.<br />相反的；<br />vt.<br />反击，还击；反向移动，对着干；反驳，回答；<br />vi.<br />逆向移动，对着干；反驳；<br />adv.<br />反方向地；背道而驰地；
cracy	做词根时的意思：<br />rule,统治或政体<br />eg：<br />democracy<br />民众；民主国家；民主主义；民主政治；<br />bureaucracy<br />官僚主义；官僚机构；官僚政治；<br />plutocracy<br />富豪统治，财阀统治；富豪[财阀]统治集团，富豪，财阀；	***************<br />做单词时的意思：<br />suff. 统治；政体；
crat	做词根时的意思：<br />ruler,统治者<br />eg：<br />democrat<br />民主主义者，民主人士；民主党人；<美>民主党党员；<br />autocrat<br />独裁统治者；独断专行的人；<br />plutocrat<br />富豪，财阀；	***************<br />做单词时的意思：<br />abbr.<br />Crater 弹坑；
cre	做词根时的意思：<br />grow,make，增长，产生<br />eg：<br />creative<br />创造性的，有创造力的；有创意的，创新的，创造的；  （非正式）创意人士；<br />creature<br />生物，动物；人；创造物；（他人的）工具；<br />recreation<br />消遣（方式）；娱乐（方式）；重建，重现；	***************<br />做单词时的意思：<br />abbr.<br />credit 贷方；corrosion resistant 防腐
creed	做词根时的意思：<br />believe,trust,相信,信任<br />eg：<br />credo<br />信经，信条；<br />credence<br />相信（传言）；凭证；餐具柜；[宗]祭器台；<br />credit<br />信誉，信用；[金融]贷款；荣誉；学分；  相信，信任；归功于；[会]记入贷方；赞颂；	***************<br />做单词时的意思：<br />n.<br />（尤指宗教）信条，教义；主义，纲领；宗派；
cret	做词根时的意思：<br />sure, separate,搞清，区别<br />eg：<br />discrete<br />分离的，不相关联的；分立式；非连续；<br />discretion<br />慎重；考虑周到；判断力，辨别力；自行决定的自由；<br />discreet<br />谨慎的，慎重的；考虑周到的；小心的；持重；	***************<br />做单词时的意思：<br />[医][=Committee on Residency Educ
crit	做词根时的意思：<br />judge,discern,判断，分辨<br />eg：<br />critical<br />批评的，爱挑剔的；关键的；严重的；极重要的；<br />criticism<br />批评，批判；鉴定，审定，考证，校勘；苛求，[哲]批判主义；评论，<br />criterion<br />（批评、判断等的）标准，准则；规范；	***************<br />做单词时的意思：<br />n.<br />[指环王Online]critical hit or cast,
cru	做词根时的意思：<br />cross,十字形，交叉<br />eg：<br />crucial<br />关键性的，极其显要的；决定性的；十字形的；<br />crusade<br />[史]十字军东征；（宗教性的）圣战；改革运动；  加入十字军；从事改革运动；讨伐；<br />excruciate<br />（精神上）残酷折磨，（使精神上受）极大痛苦；	***************<br />做单词时的意思：<br />n.<br />（法国的）葡萄园，酒的度数；
crypt	做词根时的意思：<br />secret,hidden,秘密，隐藏<br />eg：<br />crypt<br />地窖，（尤指）教堂地下室；<br />cryptic<br />神秘的；隐藏的；有隐含意义的；使用密码的；<br />apocrypha<br />伪经(<旧约全书>中犹太人不予承认为希伯来<圣经>的经籍，在宗教	***************<br />做单词时的意思：<br />n.<br />地窖，（尤指）教堂地下室；
cub	做词根时的意思：<br />lie down,躺<br />eg：<br />cubicle<br />小卧室，斗室；<br />incubate<br />孵化；培育；  孵（卵）；<医>潜伏；逐渐形成；潜伏在体内；<br />incubation<br />孵卵；孵化；<医，生>（传染病的）潜伏期；<生>（细菌等的）繁殖	***************<br />做单词时的意思：<br />n.<br />幼小的兽；愣头青，毛头小伙子；新手；<br />v.<br />（野兽）生仔；捉幼狐（幼兽）；
culp	做词根时的意思：<br />fault，错，罪<br />eg：<br />culpable<br />应受谴责的，应受处罚的，有罪的；<br />inculpate<br />显示（某人）有罪，使负罪；<br />exculpate<br />开脱，使无罪；	***************<br />做单词时的意思：<br />abbr.<br />California Union List of Periodi
cult	做词根时的意思：<br />耕种，培养<br />eg：<br />cultivate<br />耕作，种植；教养，栽培；改善；交朋友；<br />cultivation<br />教养；栽培；耕作；（关系的）培植；<br />culture<br />文化；[生物学]（微生物等的）培养；修养；养殖；  培植，培养；	***************<br />做单词时的意思：<br />n.<br />狂热的崇拜；宗教信仰；邪教；<br />adj.<br />受特定群体欢迎的；作为偶像崇拜的；
cumb	做词根时的意思：<br />lie down,躺，障碍<br />eg：<br />succumb<br />屈服；死亡；<br />recumbent<br />躺着的；斜靠的；倚躺；<br />incumbent<br />在职的；义不容辞的；靠在[压在]上面的；弯垂下来的；  在职者；教会中的任职者；〈英〉教区牧师；	***************<br />做单词时的意思：<br />abbr.<br />Cumberland <英国>坎伯兰郡（英格兰一郡名），<美国>
cur	做词根时的意思：<br />care，关心<br />eg：<br />curious<br />好奇的； 好求知的；奇妙的； 稀奇的；<br />curiosity<br />好奇心，爱打听的癖性；奇人；奇物，古玩；奇特性；<br />secure<br />安全的；牢固的；有把握的；安心的；  保护；（使）获得；使安全；担保；  获得安全，变得安全；安全，保险；承保，担保；[航海学]停止工作；	***************<br />做单词时的意思：<br />n.<br />野狗；坏蛋，无赖；
curr	做词根时的意思：<br />run , 跑，发生<br />eg：<br />current<br />现在的；最近的；流行的；流传的；  趋势；电流；水流；涌流；<br />currency<br />货币；通用，流通，流传，传播；市价，行情；流通时间；<br />curriculum<br />全部课程，课程；	***************<br />做单词时的意思：<br />vi.<br />（鸽子、猫等）咕咕叫，发咕咕声；
cuss	做词根时的意思：<br />shake，摇动<br />eg：<br />concussion<br />震荡；脑震荡；冲击；震动；<br />discuss<br />讨论，谈论；论述，详述；商量；<br />percussion<br />敲打，碰撞；振动；<音>打击乐器；[医]扣诊法；	***************<br />做单词时的意思：<br />n.<br />诅咒，坏话，家伙；<br />v.<br />乱骂，咒骂；
custom	做词根时的意思：<br />habit，习惯<br />eg：<br />customary<br />习惯的；通常的；照惯例的；  习惯法；风俗志；<br />customer<br />顾客，客户；主顾；<口>家伙；	***************<br />做单词时的意思：<br />n.<br />习惯，惯例；海关，关税；经常光顾；[总称]（经常性的）顾客；<br />adj.<br />（衣服等）定做的，定制的；
cycl	做词根时的意思：<br />ring,circle,圆，环<br />eg：<br />cycle<br />循环，周期；自行车；时代，一段时间；整套；  周而复始，循环；骑自行车；轮转；  运转，循环；使轮转；<br />cyclone<br />气旋，旋风；飓风，暴风；旋风分离器；<br />bicycle<br />自行车；脚踏车；  骑自行车；	***************<br />做单词时的意思：<br />abbr.<br />China Young Communist League 中国共
cyn	做词根时的意思：<br />dog，狗<br />eg：<br />cynic<br />愤世嫉俗者，讽世者；犬儒学派的人；  愤世嫉俗的；犬儒学派的；<br />cynicism<br />讥笑，讥讽的言词；愤世嫉俗；玩世不恭；犬儒哲学，犬儒主义；<br />cynosure<br />引人注目的人（或物），焦点；	***************<br />做单词时的意思：<br />[医][=cyanide]氰化物；
de-	做词根时的意思：<br />去掉，变坏，离开，变慢，向下<br />eg：<br />destruction<br />破坏，毁灭，消灭，灭亡，扑灭，驱除；摧毁；毁灭的原因，破坏手段；<br />deforest<br />砍伐森林；清除…上的树林；<br />depress<br />压下，压低；使沮丧；使萧条；使跌价；	***************<br />做单词时的意思：<br />abbr.<br />demand 需要；double end 双径；data ent
deca	做词根时的意思：<br />十，数字10<br />eg：<br />decade<br />十年，十年间；十个一组；十年期；	***************<br />做单词时的意思：<br />十；
deci	做词根时的意思：<br />十分之一<br />eg：<br />decimate<br />十中抽一；大批杀害；	***************<br />做单词时的意思：<br />[计] 十分之一；
dem	做词根时的意思：<br />人民<br />eg：<br />epidemic<br />流行病；迅速的传播、生长或发展；风尚等的流行；  流行性的；极为盛行的；<br />epidemiology<br />流行病学；<br />epidemiologist<br />流行病学家；	***************<br />做单词时的意思：<br />v.<br />[卑]谴责；
demi	做词根时的意思：<br />半<br />eg：	***************<br />做单词时的意思：<br />n.<br />古希腊城邦平民，民众；
demn	做词根时的意思：<br />harm,伤害<br />eg：<br />condemn<br />（通常因道义上的原因而）谴责；宣判；宣布…不能使用；迫使…陷于不<br />condemnation<br />谴责；定罪；谴责（或定罪）的理由；征用；<br />indemnity<br />赔偿；保障；赔偿金；	***************<br />做单词时的意思：
demo	做词根时的意思：<br />人民<br />eg：<br />democracy<br />民众；民主国家；民主主义；民主政治；<br />democratic<br />民主的；民主政体的；民主主义的；<美>民主党的；<br />demography<br />人口统计学；  人口统计学的；	***************<br />做单词时的意思：<br />n.<br />演示；示威；样本唱片；民主党员；
dens	做词根时的意思：<br />make thick,变浓厚<br />eg：<br />dense<br />密集的，稠密的；浓密的，浓厚的；愚钝的；<br />density<br />密度；稠密，浓厚；[物]浓度，比重；愚钝；<br />condense<br />（使）冷凝；（使）凝结；精简；压缩；	***************<br />做单词时的意思：<br />n.<br />牙齿，齿状部分；兽窝( den的名词复数 )；窝点；休息室；书斋
dent	做词根时的意思：<br />tooth,牙齿<br />eg：<br />dentist<br />牙科医生；<br />denture<br />（一副）假牙；托牙；<br />dent<br />凹痕，凹部；齿；减少，削弱；[名]登特；  使产生凹痕；削弱；打击，破坏；产生不好的影响；  出现凹痕；产生凹陷；凹进去；削减；	***************<br />做单词时的意思：<br />n.<br />凹痕，凹部；齿；减少，削弱；[名]登特；<br />vt.<br />使产生凹痕；削弱；打击，破坏；产生不好的影响；<br />vi.<br />出现凹痕；产生凹陷；凹进去；削减；
derm	做词根时的意思：<br />skin,皮肤<br />eg：<br />epidermis<br />表皮；<br />dermal<br />皮肤的，真皮的；<br />dermatitis<br />皮炎；	***************<br />做单词时的意思：<br />n.<br />真皮，皮肤；
dexter	做词根时的意思：<br />right，右边<br />eg：<br />dexterous<br />（身手）灵巧的，敏捷的；手巧；圆熟；利落；<br />dexterity<br />灵巧；熟练；敏捷；聪敏；<br />ambidextrous<br />左右手都灵的；搞两面派的；非常灵巧的；非常熟练的；	***************<br />做单词时的意思：<br />adj.<br />右侧的；右边的；<废>幸运的；吉利的；
di-	做词根时的意思：<br />两个，双<br />eg：<br />dioxide<br />[化]二氧化物；<br />dilemma<br />窘境，困境；进退两难；<br />dichotomize<br />对分，二分；	***************<br />做单词时的意思：<br />abbr.<br />diameter 直径；diametral 直径的；(Latin
dia	做词根时的意思：<br />穿过，二者之间<br />eg：<br />dialogue<br />对话；（文学、戏剧、电影等中的）对话；对白；意见分歧者之间的意见 用对话表达；  对话；进行非正式的意见交换；<br />diameter<br />直径，直径长；放大率；<br />diaphanous<br />（织物等）（半）透明的；	***************<br />做单词时的意思：<br />abbr.<br />diagram 图表；diamond 钻石；date of in
dict	做词根时的意思：<br />say,assert, 说话，断言<br />eg：<br />dictate<br />口述；命令，指示；使听写；控制，支配；  口述；命令；  命令；指示；指导原则；<br />dictator<br />独裁者；专制者；发号施令者；专横的人；<br />diction<br />发音法；措词，用词；文辞；措辞；	***************<br />做单词时的意思：<br />abbr.<br />dictionary 字典，词典；dictation 口述；
dif	做词根时的意思：<br />不，否定，分开<br />eg：<br />differ<br />不同，相异；不同意，意见相左；争吵；<br />difference<br />差别，差异；[数]差数，差额；意见分歧；特色；  辨别，区分；<br />diffident<br />缺乏自信的，露出怯态的；羞怯的；踌躇的；虚；	***************<br />做单词时的意思：<br />abbr.<br />data interchange format 数据交换格式；d
dign	做词根时的意思：<br />worthy,noble,值得，高贵<br />eg：<br />condign<br />严厉而适当的，罪有应得的；<br />dignity<br />尊严；高尚；自豪；自尊；<br />dignitary<br />高僧；高官；显要人物；  高官的；权贵的；	***************<br />做单词时的意思：
dis-	做词根时的意思：<br />不，相反动作<br />eg：<br />disorder<br />混乱，凌乱；动乱，骚乱；不正当行为；（身心机能的）失调；  使混乱，使凌乱；扰乱；使（身心等）失调；使（神经等）错乱；<br />disappear<br />不见，消失；不复存在，灭绝；<br />disproof<br />反证，反驳；	***************<br />做单词时的意思：<br />abbr.<br />disconnect 分离；disconnection 分离；d
dit	做词根时的意思：<br />give,给予<br />eg：<br />condition<br />状态；环境；健康状况；条款；  制约；限制；使习惯于；使适应；  对…具有重要影响；影响（某事发生的方式）；保持（头发或皮肤等的）<br />tradition<br />传统；惯例；[宗]经外传说；[法]移交，引渡；<br />edit<br />剪辑（影片，录音）；编辑；校订；主编；  编辑；	***************<br />做单词时的意思：<br />n.<br />摩尔斯讯号的短音，（电信）点；
doc	做词根时的意思：<br />teach,教<br />eg：<br />doctor<br />医生，大夫；博士；神学家；医疗设备；  医疗，行医；  修理，装配；假造；搀杂；修改，修饰；<br />doctrine<br />教条，教义；法律原则；声明；古语] 所教的东西，教育；<br />doctrinaire<br />教条（主义）的；	***************<br />做单词时的意思：<br />n.<br /><口>医生；<br />abbr.<br /><口>医生；同 doctor；(j计算机) 文档；同 docum
dole	做词根时的意思：<br />grieve，悲伤<br />eg：<br />doleful<br />令人沮丧的；悲哀的；沉闷的；阴郁的；<br />condole<br />表示同情，吊唁；<br />indolence<br />懒惰；好逸恶劳；懒散；无痛；	***************<br />做单词时的意思：<br />n.<br />救济物；失业救济金；施舍物；<br />vt.<br />发放救济；少量分发；
don	做词根时的意思：<br />give,给予<br />eg：<br />donate<br />（尤指向慈善机构）捐赠；献（血）；捐（血）；捐献（器官）；  捐赠；捐献；<br />donor<br />捐赠者，[医]供血者，输血者；[医]供血者，输血者；[物]施主；<br />condone<br />容忍，宽恕，原谅；	***************<br />做单词时的意思：<br />n.<br />大学教师，（牛津、剑桥大学的）导师，特别研究员；<br />vt.<br />穿上，披上；
dorm	做词根时的意思：<br />sleep，睡眠<br />eg：<br />dormitory<br />（学校等的）宿舍；集体寝室；（在市内工作的人的）郊外住宅区；  住宅区的；<br />dormancy<br />睡眠，冬眠，隐匿；<br />dormitive<br />安眠的；  安眠药；	***************<br />做单词时的意思：<br />n.<br />宿舍；
doub	做词根时的意思：<br />二，双<br />eg：<br />doubt<br />怀疑，疑虑；未确定；  怀疑，疑惑；  不确定，不能肯定或怀疑；<br />doubtful<br />难以预测的；难以预料的，未定局的；怀疑的，拿不准的；不明不白；<br />double<br />双的；两倍的；两面派的；双人用的；  使加倍；把…对折；重复；  加倍，加倍努力；快步走；  两倍地；双重地；  两倍；双精度型；	***************<br />做单词时的意思：<br />[医][=double]成双的，两重的，两倍的；
dox	做词根时的意思：<br />opinion，观点<br />eg：<br />orthodox<br />规范的； 公认的； 普遍赞同的；正统的；<br />heterodox<br />异端的；<br />paradox<br />反论，悖论；似非而是的论点；自相矛盾的人或事；[物]佯谬；	***************<br />做单词时的意思：<br />[医][=dioxolane]二氧戊烷，二氧戊环；
draw	做词根时的意思：<br />pull，拉<br />eg：<br />drawl<br />拖长腔调慢吞吞地说；  拖长腔调慢吞吞说的话；<br />withdraw<br />撤走；拿走；撤退；（从银行） 取 （钱）；  撤退；（从活动或组织中） 退出；	***************<br />做单词时的意思：<br />vt.& vi.<br />绘画；拖，拉；招致；吸引；<br />vt.<br />画；拉；吸引；<br />vi.<br />移动；拔出剑；皱缩；汲取；<br />n.<br />平局；抽奖；
drom	做词根时的意思：<br />run，跑<br />eg：<br />syndrome<br />综合征；综合症状；典型表现；<br />dromometer<br />速度计；<br />dromedary<br />单峰骆驼；	***************<br />做单词时的意思：<br />[计]= Decoder Read Only Memory,译码
du	做词根时的意思：<br />二，双<br />eg：<br />dual<br />双的，两部分的，二体的，二重的；  双数；双数词；<br />duel<br />决斗；竞争，斗争；  使（另一人）参加决斗；反对；  参加正式决斗；<br />dubious<br />半信半疑的，犹豫不决的；可疑的；暧昧的，含糊的；不可靠的；	***************<br />做单词时的意思：<br />abbr.<br />duty 义务；dual 二的；distribution uni
duct	做词根时的意思：<br />lead,bring,引导，带来<br />eg：<br />duct<br />管，导管；（电线，电缆等的）管道；  用导管输送；用管道供应；<br />ductile<br />可延展的；有韧性的；顺从的；易受影响的；<br />educate<br />教育，教导；训练，培养；  使理解或接受；	***************<br />做单词时的意思：<br />n.<br />管，导管；（电线，电缆等的）管道；<br />vt.<br />用导管输送；用管道供应；
dur	做词根时的意思：<br />last,hard,持久，坚硬<br />eg：<br />durable<br />耐用的，耐久的；持久的；长期的；  耐用品，耐久品；<br />duration<br />持续，持续的时间，期间；（时间的）持续，持久，连续；[语音学]音<br />endure<br />忍耐；容忍；  持续，持久；忍耐；	***************<br />做单词时的意思：<br />abbr.<br />(Latin prefix=hard) （拉丁语前缀）困难的；d
dyn	做词根时的意思：<br />power,力量<br />eg：<br />dynasty<br />王朝；朝代；<br />dynamics<br />动力学、力学；（音乐中的）力度变化；力度强弱法；动态；动力( d<br />dynamo<br />精力充沛的人；[物]发电机；	***************<br />做单词时的意思：<br />n.<br />力学，动力学；
dys	做词根时的意思：<br />坏，不良<br />eg：<br />dystrophy<br />营养不良；<br />dyspepsia<br />消化不良；	***************<br />做单词时的意思：<br />[医] 不良，困难，障碍；
e-	做词根时的意思：<br />出，向外<br />eg：<br />elongate<br />延长，加长；<br />elaborate<br />详尽说明；变得复杂；  详细制定；详尽阐述；[生理学]加工；尽心竭力地做；  复杂的；精心制作的；（结构）复杂的；精巧的；<br />eject<br />喷出；驱逐；强制离开；  弹射出；	***************<br />做单词时的意思：<br />n.<br />英语字母表的第5个字母；C大调音阶中的第三音；
ego	做词根时的意思：<br />我，自己<br />eg：<br />egoism<br />自我主义，利己主义，自私自利；<br />egocentric<br />自我中心的，自私自利的；<br />egoist<br />自我主义者；	***************<br />做单词时的意思：<br />n.<br />自我；自负；自尊心；自我意识；
em-	做词根时的意思：<br />进入…之中，包围<br />eg：<br />embrace<br />拥抱；  包括；包含；接受；信奉；  拥抱，怀抱；<br />embed<br />把…嵌入；栽种；深留（记忆中）；<br />empathy<br /><心>移情作用；同感，共鸣；神入；	***************<br />做单词时的意思：<br />n.<br />全身，行长单位；<br />adj.<br />全身长（或宽）的（印刷符号）；
emper	做词根时的意思：<br />command，命令，统治<br />eg：<br />empire<br />帝国，帝国领土；帝权，君权，最高统治权；大企业组织；  新古典风格的；<br />imperial<br />帝国的，皇帝的；皇家的，庄严的；特级的；度量衡英制的；  纸张尺寸，通常是23×23英寸；特大号，特级品；一小绺胡须；马车<br />imperious<br />专横的，飞扬跋扈的；	***************<br />做单词时的意思：
empt	做词根时的意思：<br />take,procure,拿，获得<br />eg：<br />exempt<br />使免除，豁免；  被免除的，被豁免的；  被免除（义务，责任）的人；免税人；<br />exemption<br />（义务等的）免除；免（税）；（收入中的）免税额；<br />peremptory<br />断然的；不容置辩的；傲慢的；专横的；	***************<br />做单词时的意思：<br />abbr.<br />epitaxial mesa phototransistor 外
en-	做词根时的意思：<br />进入…之中，包围<br />eg：<br />enroll<br />注册；登记；加入；招收；<br />enchain<br />束缚，以铁链绑住；<br />encage<br />关在笼中，把…关起来，禁闭；	***************<br />做单词时的意思：<br />n.<br />N字，半方；<br />prep.<br /><法>在，在…中；
endo	做词根时的意思：<br />内部<br />eg：	***************<br />做单词时的意思：<br />内；
epi	做词根时的意思：<br />在…上，在…周围，在…后面<br />eg：<br />epidemic<br />流行病；迅速的传播、生长或发展；风尚等的流行；  流行性的；极为盛行的；<br />epigram<br />机智的短诗，警句，讽刺诗；<br />epilogue<br />（文艺作品的）尾声；后记；（戏剧等的）收场诗；收场白；	***************<br />做单词时的意思：<br />n.<br />直沙嘴，离岸沙坝；
equ	做词根时的意思：<br />equal,even,相等，平均<br />eg：<br />equal<br />相等的，平等的；平稳的；势均力敌的；胜任的；  等于；比得上；使相等；同样看待；  同样的人；相等的数量；能与之比拟的东西；（地位、实力等）相同的人 相等，相平（与out连用）；<br />equality<br />同等，平等；[数]相等，等式；<br />equate<br />使相等；相当于；等同；	***************<br />做单词时的意思：<br />abbr.<br />equate 使相等；equation 相等；方程式；equit
erg	做词根时的意思：<br />能量，活动<br />eg：<br />energetic<br />精力充沛的，充满活力的；精力旺盛的，精神饱满的；（措施等）积极的<br />synergic<br />协作的，合作的；<br />lethargic<br />昏睡的；没精打采的，懒洋洋的；暮气沉沉；苶；	***************<br />做单词时的意思：<br />n.<br />尔格（功的单位）；
err	做词根时的意思：<br />错误<br />eg：<br />error<br />错误，过失；[法]误审，违法；[数]误差；<br />erroneous<br />错误的；不正确的；秕谬；讹；<br />erratic<br />飘忽不定的；行为古怪，反复无常；（运动或行为）不规则的；  古怪的人；[地]漂砾；	***************<br />做单词时的意思：<br />vi.<br />犯错，做错；走上歧途；犯罪；
esthet	做词根时的意思：<br />feeling，感觉<br />eg：<br />aesthetic<br />美的，美学的；有关美的；审美的；具有审美趣味的；  美学标准，美感；审美观；<br />aesthetics<br />美学；美术理论；审美学；美的哲学；<br />anesthesia<br />感觉缺失，麻木；麻醉；	***************<br />做单词时的意思：
eu	做词根时的意思：<br />好，优秀<br />eg：<br />eulogize<br />称赞，颂扬；讴歌；<br />euphemism<br />委婉语；委婉说法；<br />euphonious<br /><正>悦耳的；	***************<br />做单词时的意思：<br />abbr.<br />(Greek=good or well) （希腊语）好的；ele
ex-	做词根时的意思：<br />出，出去<br />eg：<br />exclude<br />排除，不包括；排斥；驱除，赶出；<br />expel<br />驱逐；赶走；把…除名；排出（气体等）；<br />expose<br />揭露，揭发；使暴露；使遭受；使曝光；	***************<br />做单词时的意思：<br />n.<br /><口>前妻或前夫，以前的男朋友或女朋友；<br />prep.<br />不包括，除…之外；
exo	做词根时的意思：<br />外部的，外面<br />eg：<br />exotic<br />异国的；外来的；异乎寻常的，奇异的；吸引人的；  舶来品，外来物；脱衣舞女；<br />exodus<br />离去，退出；古代以色列人出埃及；<br />exothermic<br />发热的，放出热量的；	***************<br />做单词时的意思：<br />abbr.<br />exopolysaccharide 表多糖；
extr	做词根时的意思：<br />out,出去<br />eg：<br />extra<br />额外的，补充的，附加的；特大的，特别的；  附加物，额外的事物；临时演员；号外；上等产品，上品；  额外地；格外地，特别地；<br />extraneous<br />外部的；外来的；无关的；不相干的；<br />extreme<br />极端的，过激的；极限的，非常的；末端的；（政治上）急进的；  极端；困境；[数]极限值；[常用复数]在两末端的事物；	***************<br />做单词时的意思：<br />abbr.<br />extrusion 挤出；extrude 挤压出；extraor
extra	做词根时的意思：<br />额外的，超过的<br />eg：<br />extraordinary<br />非凡的；特别的；非常奇特的；<br />extraneous<br />外部的；外来的；无关的；不相干的；<br />extravagant<br />过度的，过分的；奢侈的，浪费的；放肆的；大量的；	***************<br />做单词时的意思：<br />adj.<br />额外的，补充的，附加的；特大的，特别的；<br />n.<br />附加物，额外的事物；临时演员；号外；上等产品，上品；<br />adv.<br />额外地；格外地，特别地；
fabl	做词根时的意思：<br />speak,讲，说<br />eg：<br />fable<br />寓言，童话；传说；无稽之谈；人人谈论的话题；  讲故事，编寓言；虚构，杜撰；煞有介事地讲；<br />fabulous<br />极好的，极妙的；（美貌）惊人的；寓言般的；难以置信的；<br />affable<br />友善的；和蔼的；平易近人的；（天气）宜人；	***************<br />做单词时的意思：<br />abbr.<br />fire alarm bell 火警铃；
fabric	做词根时的意思：<br />make，制作<br />eg：<br />prefabricated<br />（建筑物、船等）预制构件的；  预制( prefabricate的过去式和过去分词 )；	***************<br />做单词时的意思：<br />n.<br />织物；布；构造；（建筑物的）结构（如墙、地面、屋顶）：质地；
fac	做词根时的意思：<br />do,做<br />eg：<br />facile<br />轻率作出的；不动脑筋的；轻易可得的；<br />facilitate<br />促进，助长；使容易；帮助；<br />facility<br />设备；容易；能力；灵巧；	***************<br />做单词时的意思：<br />abbr.<br />factor 因素；facial 面部的；facility 容易
fact	做词根时的意思：<br />do,做<br />eg：<br />factor<br />因素；<数>因子；代理人；  把…因素包括进去；[数学]分解…的因子，将…分解成因子；以代理商 做代理商（或管家）；<br />benefactor<br />捐助者；施主；恩人；<br />benefaction<br />善行； 善举；赠品； 捐赠；	***************<br />做单词时的意思：<br />n.<br />事实，实情；实际；真相，证据；犯罪行为；
fal	做词根时的意思：<br />err,deceive,犯错误，欺骗<br />eg：<br />fallacy<br />谬误，谬见；谬论；错误；<br />fallacious<br />谬误的；虚妄的；欺骗的 ；靠不住的；<br />fallible<br />容易犯错的；	***************<br />做单词时的意思：<br />[计]= File Access Listener,文件存取监听
fect	做词根时的意思：<br />do,做<br />eg：<br />affected<br />感动的；受到影响的；（人或行为）假装的；倾向于…的；  影响( affect的过去式和过去分词 )；假装；感动；（疾病）<br />affection<br />喜爱，慈爱；情感或感情；意向；疾病，病情；<br />affectation<br />假装；装模作样；装模作样的言行；矫情；	***************<br />做单词时的意思：<br />电场效应；
fem	做词根时的意思：<br />女<br />eg：<br />female<br />女性的；雌性的；能结果实的；电气设备阴的；  女人；雌性动物；雌性植物，雌株；<br />feminine<br />有女性气质的；女子气的；[语]阴性的；阴柔的；  女性；温柔的女性；[语]阴性，阴性词；<br />feminism<br />女权主义；争取女权的运动；	***************<br />做单词时的意思：<br />n.<br />女子；
fend	做词根时的意思：<br />strke，打击<br />eg：<br />defend<br />辩护；保卫；（足球、曲棍球等）防守；进行辩护；<br />defense<br />(D-)（美国）国防部，防卫，防卫物；  谋划抵御；<br />fend<br />谋生；防御，保护；供养；闪避，挡开；  照料；供养；力争；	***************<br />做单词时的意思：<br />vt.& vi.<br />谋生；防御，保护；供养；闪避，挡开；<br />vi.<br />照料；供养；力争；
fer	做词根时的意思：<br />bring,carry,带来，拿来<br />eg：<br />ferry<br />渡船；渡口；摆渡；用船渡运；  航海；渡运；（乘渡船）渡过（河等）；  摆渡；<br />confer<br />授予，颁与；比较，对照；  商议，磋商；<br />conference<br />会议；讨论；（正式）讨论会；[工会、工党用语]（每年的）大会；  举行或参加（系列）会议；	***************<br />做单词时的意思：<br />abbr.<br />ferre (Latin=to bear) （拉丁语）肥沃的；富
ferv	做词根时的意思：<br />boil,沸，热<br />eg：<br />fervid<br />充满激情的，热烈的；<br />perfervid<br />极其热情的；<br />fervor<br />热烈，热情；	***************<br />做单词时的意思：<br />abbr.<br />Fervidor (French=Glowing Month)
fess	做词根时的意思：<br />speak，说<br />eg：<br />confess<br />供认；坦白；承认；悔过；<br />profession<br />职业，专业；同行；宣称；信念，信仰；<br />professional<br />专业的；专业性的；职业的；  专业人士；	***************<br />做单词时的意思：<br />v.<br />坦白，供认；
fest	做词根时的意思：<br />hostile，仇恨<br />eg：<br />infest<br />大批出没，成群出现；在…上寄生，寄生于；骚扰；<br />manifest<br />显示，表明；证明；使显现；  明白的，明显的；  货单，旅客名单；	***************<br />做单词时的意思：<br />[医]（德）固体的；
fid	做词根时的意思：<br />trust,faith,相信，信念<br />eg：<br />fidelity<br />忠诚，忠实；逼真；保真度；尽责；<br />confide<br />吐露（秘密、心事等）；委托，托付；  吐露秘密；信任，信赖；<br />confidant<br />心腹朋友，知己；	***************<br />做单词时的意思：<br />n.<br />（一）块， （一）堆；（支撑中桅的）方形木杠[铁杠]；（拼接、迭
fil	做词根时的意思：<br />thread,线条<br />eg：<br />filament<br />[印，纺]长丝，单纤维；[电]灯丝，丝极，游丝；细丝，丝状体；[<br />filigree<br />（用金丝等制成的）精工制品；精致的物品；华而不实的东西；<br />filibuster<br />[史]掠夺兵，暴兵；海盗；阻挠议事的议员；会议妨碍行为；  阻碍议案通过；  阻饶议事；掠夺，侵夺；	***************<br />做单词时的意思：<br />n.<br />费尔（伊拉克的钱币）；
fin	做词根时的意思：<br />end,boundary,结束，范围<br />eg：<br />finish<br />完成；结束；吃光；使筋疲力尽；  结尾；结束；最后阶段；抛光；<br />finale<br />[乐]终曲；结局，大团圆；最后一场，最后乐章；尾声；<br />finance<br />财政；金融；财源；资金；  为…供给资金， 从事金融活动；赊货给…；掌握财政；	***************<br />做单词时的意思：<br />n.<br />鱼鳍；鳍状物；（汽车、飞机、炸弹上的）尾翅；散热片；<br />vt.<br />给…装上翅片；切除鳍；<br />vi.<br />潜泳；（猛烈地）拍动（鳍）；
firm	做词根时的意思：<br />坚定<br />eg：<br />infirm<br />体弱的；<br />affirm<br />断言，肯定；证实，确实；[法]不经宣誓而庄严宣布；承认；<br />affirmative<br />肯定的；赞成的，同意的；积极的，乐观的；  肯定词，肯定语；正方；确言，赞成；	***************<br />做单词时的意思：<br />adj.<br />坚固的，坚牢的；坚定的，坚决的；严格的；确定的；<br />vt.& vi.<br />使坚固；使坚实；<br />n.<br />商号，商行；公司；企业；工作集体；<br />adv.<br />坚定地，稳固地；<br />vt.<br />使坚定，使牢固；<br />vi.<br />变坚实，变稳固；
fiss	做词根时的意思：<br />split,分裂<br />eg：<br />fissure<br />狭长裂缝或裂隙；裂伤；分歧； 分裂；  裂开；<br />fissile<br />可进行核裂变的；易裂的，可裂的；	***************<br />做单词时的意思：<br />abbr.<br />(Latin prefix=split) （拉丁语前缀）裂缝，裂<br />13<br />(Latin prefix=split) （拉丁语前缀）裂缝，裂
fix	做词根时的意思：<br />固定<br />eg：<br />fixture<br />（房屋等的）固定装置；[商]定期放款，定期存款；固定在某位置的人<br />affix<br />附加；粘贴；加以；盖（印章）；  附加物；添加物；附件；<语法>词缀；<br />prefix<br /><语>前缀；人名前的称谓；前置代号（置于前面的单词或字母、数字） 在…前加前缀；在…前加上；	***************<br />做单词时的意思：<br />vt.<br />固定；准备；修理；使牢固；<br />vi.<br />固着；变硬；安定；<br />n.<br />困境；定位于；受操纵的事；应急措施；
flat	做词根时的意思：<br />blow，吹<br />eg：<br />inflate<br />使充气（于轮胎、气球等）；（使）膨胀；（使）通货膨胀；物价上涨；<br />inflation<br />膨胀；通货膨胀；夸张；自命不凡；<br />deflate<br />放气；瘪下来；使泄气；紧缩；	***************<br />做单词时的意思：<br />adj.<br />平的；单调的；不景气的；干脆的；<br />adv.<br />（尤指贴着另一表面）平直地；断然地；水平地；直接地，完全地；<br />n.<br />平地；公寓；平面；<br />vt.<br />使变平；[音乐]使（音调）下降，尤指降半音；<br />vi.<br />逐渐变平；[音乐]以降调唱（或奏）；
flect	做词根时的意思：<br />bend,弯曲<br />eg：<br />deflect<br />使歪斜；使弯曲；偏转，偏离；<br />genuflect<br />屈膝（尤指宗教礼节中）；<br />reflect<br />反射（光、热、声或影像）；考虑；  反射，反照；表达；显示；折转；  映出；反射；深思熟虑；慎重表达；	***************<br />做单词时的意思：
flex	做词根时的意思：<br />弯曲<br />eg：<br />inflexible<br />僵硬的，不可弯曲的；不屈服的；不能转变的；坚定不移的；<br />inflex<br />弯曲，挠曲；<br />deflex<br />使向下弯曲；	***************<br />做单词时的意思：<br />v.<br />弯曲（关节）；收缩（肌肉）；显示力量；<br />n.<br />弯曲；[电]花线；
flict	做词根时的意思：<br />strike,打击<br />eg：<br />afflict<br />使受痛苦；折磨；使苦恼；<br />affliction<br />苦恼，痛苦；灾难；哀伤，忧伤；<天>受克星体；<br />conflict<br />冲突；战斗；相互干扰；矛盾；  抵触；争斗；战斗；冲突；	***************<br />做单词时的意思：<br />[医]心理内冲突；
flor	做词根时的意思：<br />flower,花<br />eg：<br />floral<br />花的，花似的；以花装饰的；植物的，植物群的；花神的；<br />florid<br />红润的；华丽的；炫耀的；绚丽；<br />florescence<br />开花，全盛期，花期；	***************<br />做单词时的意思：<br />n.<br />浮在葡萄酒表面的一种白色酵母；菌膜；酒花；
flu	做词根时的意思：<br />flow,流动<br />eg：<br />fluid<br />液体，流体；  流体的，流动的，流体的，液体的；易变的，不固定的；（动作、设计、<br />flush<br />脸红；呈红色；奔流；冲刷；  满面红光的；富足的，丰富的；盈满的，没过的；水平的，同高的；  奔流，涌出；脸红或发亮；发热；强烈情感的冲动；  发红或发亮；使兴奋或得意；（以水）冲刷，冲洗；冲掉，除掉；<br />flux<br />[物]流量；流出；熔解；不断的变动；  熔化；熔解；流出；	***************<br />做单词时的意思：<br />n.<br />流行性感冒，流感；
foli	做词根时的意思：<br />leaf，树叶<br />eg：<br />foliage<br />植物的叶子（总称），叶子及梗和枝；树叶；<br />defoliate<br />（使）落叶；	***************<br />做单词时的意思：
fore	做词根时的意思：<br />前面，预先<br />eg：<br />forestall<br />先发制人，预先阻止；垄断，屯积；领先；<br />forebode<br /><正>预示（灾祸等）；<br />forecast<br />预报，预测；预示；  预报，预测；  预报；预言；	***************<br />做单词时的意思：<br />adj.<br />在前部的；以前的；<br />adv.<br />在前头，朝前头；在前面；<br />n.<br />前部；船头；<br />prep.<br />在…前；<br />int.<br />（打高尔夫球者的叫声）让开！；
form	做词根时的意思：<br />shape,形状<br />eg：<br />formal<br />（学校教育或培训）正规的；方式上的；礼仪上的；  <美>须穿礼服的社交集会；<口>夜礼服；<br />formality<br />礼节；拘谨；正式手续；<br />formation<br />形成；构成，结构；形成物；编队，队形；	***************<br />做单词时的意思：<br />n.<br />形状，形式；外形；方式；表格；<br />vt.<br />形成；构成；组织；塑造；<br />vi.<br />形成，产生；排队，整队；
fort	做词根时的意思：<br />strong,强大，力量<br />eg：<br />fort<br />堡垒，要塞；<美>边界贸易站；  设要塞保卫；<br />fortify<br />加强，增强；增加营养物；使体力增加；鼓励，使（意志等）坚定；  构筑防御工事；<br />fortitude<br />坚韧，刚毅；刚毅精神；松柏节操；	***************<br />做单词时的意思：<br />n.<br />堡垒，要塞；<美>边界贸易站；<br />v.<br />设要塞保卫；
found	做词根时的意思：<br />base，基础<br />eg：<br />foundation<br />地基；基础；基金（会）；粉底；<br />founder<br />失败；倒塌；沉没：沉到水下；摔倒：跌倒；  破坏；使摔倒；使沉没；  创始人；建立者；翻砂工；蹄叶炎；<br />profound<br />深厚的；意义深远的；严重的；知识渊博的；  〈诗〉深海，大洋；深渊；（灵魂）深处；	***************<br />做单词时的意思：<br />vt.<br />创办，成立，建立；<br />v.<br />发现（ find的过去式）；找到；到达；发觉；
fract	做词根时的意思：<br />break,打碎<br />eg：<br />fraction<br />[数]分数；一小部分，些微；不相连的一块，片段；[化]分馏；<br />fractional<br />[数]分数的，小数的；微小的，极小的；部分的，少量的；零碎的；<br />fractious<br />易怒的，急躁的；	***************<br />做单词时的意思：<br />[医][=fraction]部分，成分，分数；
frag	做词根时的意思：<br />break,打碎<br />eg：<br />fragile<br />易碎的，脆的；虚弱的；<br />fragment<br />碎片；片段，未完成的部分；（将文件内容）分段；  （使）碎裂，破裂，分裂；  破碎，碎裂；<br />suffrage<br />（政治性选举的）选举权，投票权；	***************<br />做单词时的意思：<br />vt.<br /><美><军><俚>（尤指用手榴弹）蓄意杀伤（上级军官或同伴）；
frig	做词根时的意思：<br />cold,冷<br />eg：<br />frigid<br />寒冷的；极冷的；冷漠的；（尤指女人）性冷淡的；  寒冷地，冷漠地；  寒冷，冷漠；<br />frigidity<br />寒冷；冷淡；索然无味；<医>（尤指妇女的）性感缺失；<br />refrigerate<br />冷藏；冷冻；	***************<br />做单词时的意思：<br />n.<br />冰箱；<br />v.<br />与（女子）发生性行为；
front	做词根时的意思：<br />forehead，前额<br />eg：<br />affront<br />（当众）侮辱，（故意）冒犯；  公开侮辱；冒犯；面对；<古>相遇；<br />confront<br />面对；使面对面，使对质；碰到，遇到；比较；<br />effrontery<br />厚颜无耻，无礼（的行为）；	***************<br />做单词时的意思：<br />n.<br />前面；正面；身体前部；前线；<br />adj.<br />前面的；正面的；舌前的；<br />v.<br />面向；在…前面；用…作正面；领导；
fug	做词根时的意思：<br />flee,逃，离开<br />eg：<br />refugee<br />避难者，难民；<br />centrifugal<br />离心的；<br />subterfuge<br />（用说谎或欺骗以逃脱责备、困难等的）花招，遁词；	***************<br />做单词时的意思：<br />n.<br />室内的闷浊空气；<br />v.<br />呆在闷室中，使闷塞；
fum	做词根时的意思：<br />smoke，烟<br />eg：<br />fume<br />烟气，烟雾；愤怒，烦恼；  冒烟；发怒；  用烟熏；烘制（木材等）；<br />fumigate<br />用化学品熏（某物）消毒；<br />perfume<br />香水；香料；香味，香气；  使…充满香气；喷香水于…；	***************<br />做单词时的意思：<br />[医][=5-fluorouracil and methotre<br />0<br />[医][=5-fluorouracil and methotre
funct	做词根时的意思：<br />perform，活动<br />eg：<br />function<br />功能，作用；应变量，函数；职务；重大聚会；  有或起作用；行使职责；<br />defunct<br /><正>已故的，不存在的；无效的，失效的；非现存的；  死者，死人；	***************<br />做单词时的意思：<br />abbr.<br />function 官能；功能；functional 功能的；fu<br />13<br />function 官能；功能；functional 功能的；fu
fus	做词根时的意思：<br />pour,流，泻<br />eg：<br />confuse<br />使困窘；使混乱；使困惑；使更难于理解；  使糊涂；<br />confusion<br />混乱；混淆；困惑；<br />diffuse<br />四散的；散开的；冗长的；累赘的；  传播；四散；  漫射；发散；弥漫；舒缓；	***************<br />做单词时的意思：<br />abbr.<br />fuse 熔丝；fusing 熔融；fuselage 机身；fi
gam	做词根时的意思：<br />marriage，婚姻<br />eg：<br />monogamy<br />一夫一妻制；<br />misogamy<br />厌恶结婚；<br />endogamy<br />同族结婚，同系配合，同系交配；内婚制；	***************<br />做单词时的意思：<br />n.<br />鲸鱼群，社交，腿；<br />v.<br />社交，联欢；
gar	做词根时的意思：<br />furnish，装饰，供应<br />eg：<br />garment<br />衣服；服装；  给…穿衣服；<br />garnish<br />装饰，文饰；给…加配菜；[法]传讯；  装饰，装饰品；华丽的词藻；配菜；<俚>勒索金；<br />garrison<br />守备部队，卫戍部队；要塞，驻防区；加里森；  守卫；驻防；	***************<br />做单词时的意思：<br />n.<br />长嘴硬鳞鱼，雀鳝属鱼，雀鳝；
gen	做词根时的意思：<br />birth,produce,出生，产生<br />eg：<br />generate<br />形成，造成；产生物理反应；产生（后代）；引起；<br />generation<br />一代人；代（约30年），时代；生殖；产生；<br />generator<br />发电机，发生器；电力公司；生产者，创始者；[乐]基础低音；	***************<br />做单词时的意思：<br />n.<br /><英俚>情报；
gest	做词根时的意思：<br />carry,bring,带来，产生<br />eg：<br />gesture<br />手势，姿势；举止，动作；〔古语〕仪态；[计算机]光笔指令；  做手势；  用手势表现，表达或指导；<br />gesticulate<br />做手势示意或强调；  做手势，做示意动作，手势；<br />congest<br />充满，拥挤；	***************<br />做单词时的意思：<br />n.<br />故事诗，武功，故事；
gnos	做词根时的意思：<br />know,知道<br />eg：<br />diagnosis<br />诊断；诊断结论；判断；结论；<br />prognosis<br />[医]预后，判病结局；预测；<br />agnostic<br />不可知论者；  不可知论（者）的；	***************<br />做单词时的意思：
gon	做词根时的意思：<br />angle,角<br />eg：<br />perigon<br />周角，三百六十度角；<br />pentagon<br />五边形，五角形；五角大楼（指美国国防部）；<br />diagonal<br />[数]对角线；斜线；斜列；斜纹布；  对角线的；斜线的；斜的；斜纹的；	***************<br />做单词时的意思：<br />n.<br />度（平面角单位，等于直角的百分之一）；
grad	做词根时的意思：<br />step,grade,步，级<br />eg：<br />gradation<br />（从一事物到另一事物的）渐变；（事物划分的）阶段；等级；刻度；<br />gradual<br />渐进的，渐（升）降的；倾斜度小的；逐次的，逐渐的；平缓的；  弥撒升阶圣歌；弥撒圣歌集；<br />graduate<br />渐变；渐渐变为（与into连用）；渐渐消逝（与away连用）；取 授予学位或毕业证书；从…接受学位；分成等级；标以刻度；  <美>毕业生；<英>大学毕业生；（已经取得学士学位正在攻读高级学 <美>毕业了的，研究生的；有（学士）学位的；	***************<br />做单词时的意思：<br />n.<br />毕业生，校友；研究生；
gram	做词根时的意思：<br />write,写，画图<br />eg：<br />epigram<br />机智的短诗，警句，讽刺诗；<br />grammar<br />语法；语法书；（学术的）基本原理；（人的）语言知识及运用能力；<br />diagram<br />图表；图解；示意图；[数]线图；  用图表示；图解；	***************<br />做单词时的意思：<br />n.<br />绿豆；鹰嘴豆；绿豆种子；克；
gran	做词根时的意思：<br />grain，颗粒<br />eg：<br />granary<br />谷仓，粮仓；<br />granule<br />小颗粒，小硬粒；<br />granulate<br />使成颗粒，使成粒状；使表面粗糙；	***************<br />做单词时的意思：<br />n.<br /><非>奶奶，外祖母；
graph	做词根时的意思：<br />write,写，画图<br />eg：<br />biography<br />传记；档案；传记体文学；个人简介；<br />biographer<br />传记作者；<br />monograph<br />专著，专论；	***************<br />做单词时的意思：<br />n.<br />图表，曲线图；词的拼法；<br />vt.<br />用曲线图表示，把…绘入图表；用胶版印刷；
grat	做词根时的意思：<br />pleasing,感激，高兴<br />eg：<br />gratitude<br />感激，感谢；感激的样子；谢意；恩义；<br />gratuity<br />报酬；小账；小费；养老金；<br />gratuitous<br />免费的，无偿的；无必要的；无故的，无理由的；	***************<br />做单词时的意思：<br />greet的过去式；
grav	做词根时的意思：<br />heavy,重<br />eg：<br />grave<br />重大的，重要的；严重的；[音乐]沉重的；（颜色等）朴素的；  沉重地，庄重地；极慢地；  坟墓，墓穴；埋葬…的地方；下场；死亡；  雕刻；铭记；<br />aggravate<br />加重，使恶化；使恼火；激怒；<br />gravity<br />重力；万有引力，地心引力；重要性，严重性；严肃，庄重；	***************<br />做单词时的意思：<br />n.<br />格拉夫（加速度单位，等于自由落体加速度，即9。80665米/平方
greg	做词根时的意思：<br />group,群体<br />eg：<br />gregarious<br />爱交际的，合群的；群居；<br />aggregate<br />合计；聚集体；骨料；集料（可成混凝土或修路等用的）；  总数的，总计的；聚合的；[地]聚成岩的；  使聚集，使积聚；总计达；<br />aggregation<br />聚集；集成；集结；聚集体；	***************<br />做单词时的意思：<br />n.<br />格雷格(Gregory的昵称)(m.)；
gress	做词根时的意思：<br />go,walk,行走<br />eg：<br />aggression<br />侵略，侵略行为；攻击，进攻；<br />aggressive<br />侵略的，侵犯的，攻势的；（美）有进取心的，积极行动的；有进取心的<br />congress<br />国会；代表大会；（用于某些国家的政党名称）国民大会；社交；  开会，集合；	***************<br />做单词时的意思：<br />[人名] 格雷斯；[地名] [英国] 格雷斯；
gyn	做词根时的意思：<br />woman,妇女<br />eg：<br />gynecology<br />妇科医学；<br />philogynist<br />喜欢女子的人，爱慕女子的人；<br />misogynist<br />厌恶女人的人；	***************<br />做单词时的意思：<br />n.<br />三脚起重架；
gynec	做词根时的意思：<br />女，妇女<br />eg：<br />gynecology<br />妇科医学；<br />gynecologist<br />妇科医生；	***************<br />做单词时的意思：<br />[医]女性，雌性；<br />0<br />[医]女性，雌性；
habit	做词根时的意思：<br />dwell,居住<br />eg：<br />habituate<br />使习惯于；<br />habitual<br />习惯的；惯常的；习以为常的；<br />habitat<br />（动物的）栖息地，住处；产地；经常发现某种事物的地方；	***************<br />做单词时的意思：<br />n.<br />习惯，习性；气质；宗教服装；<br />vt.<br />给…穿衣服；打扮；
hal	做词根时的意思：<br />breathe，呼吸<br />eg：<br />inhale<br />吸入；〈非〉狼吞虎咽；吸气；<br />halitosis<br /><美>口臭；<br />inhalation<br />吸入；吸入剂，吸入物；	***************<br />做单词时的意思：<br />abbr.<br />halogen 卤素（的）；handicapped assist
hap	做词根时的意思：<br />chance,机会，运气<br />eg：<br />perhaps<br />或许；（表示不确定）也许；（用于粗略的估计）或许；（表示勉强同意 假定；猜想；未定之事；<br />happen<br />发生；碰巧；出现；偶然遇到；<br />happy<br />幸福的；快乐的；巧妙的；〈口〉有点醉意的；	***************<br />做单词时的意思：<br />n.<br />偶然，机会，运气；<br />vi.<br />偶然发生；
haust	做词根时的意思：<br />draw water，抽水<br />eg：<br />exhaust<br />用尽，耗尽；使精疲力尽；排出；彻底探讨；  排气；  （排出的）废气；排出；排气装置；<br />exhausted<br />耗尽的；用完的；筋疲力尽的；精疲力竭的；  用尽( exhaust的过去式和过去分词 )；使非常疲倦；详尽讨<br />exhaustive<br />彻底的，透彻的；消耗的，使枯竭的；详尽的，无遗的；详尽无遗；	***************<br />做单词时的意思：<br />n.<br />（处方）顿服药；
hecto	做词根时的意思：<br />百，许多<br />eg：<br />hectowatt<br />百瓦；百瓦特；<br />hectogram<br />一百公克；	***************<br />做单词时的意思：<br />[电] 格克脱；
helic	做词根时的意思：<br />spiral，螺旋<br />eg：<br />helicopter<br />直升机，直升飞机；  用直升飞机载送；  乘直升飞机；<br />helix<br />螺旋结构；<br />helical<br />螺旋状的；螺线；	***************<br />做单词时的意思：
helio	做词根时的意思：<br />sun，太阳<br />eg：<br />heliotropism<br />向日性，趋日性；<br />heliotherapy<br />日光浴治疗法；<br />heliosis<br />日射病，中暑；	***************<br />做单词时的意思：<br />abbr.<br />heliotype 胶版（画）；heliodon 日影仪；hel<br />13<br />heliotype 胶版（画）；heliodon 日影仪；hel
hemi	做词根时的意思：<br />半<br />eg：<br />hemisphere<br />半球；地球的半球；[解]大脑半球；<br />hemicycle<br />半圆形，半圆形斗技场，半圆形房间；半个圆；	***************<br />做单词时的意思：<br />n.<br />半；
hepta	做词根时的意思：<br />七<br />eg：<br />heptaglot<br />使用七种语言的，用七种语言写成的；<br />heptagon<br />七角形，七边形；	***************<br />做单词时的意思：<br />n.<br />七；
her	做词根时的意思：<br />stick,粘附<br />eg：<br />adhere<br />黏附；附着；坚持；追随；  使粘附；遵循，坚持；追随，依附；<br />adherent<br />支持者，拥护者；  粘着的；<植>贴生的；（由于协议、合约等而）发生关系的；<语>修<br />cohere<br />黏合；联合；结合；（指看法、推理等）前后一致；	***************<br />做单词时的意思：<br />pron.<br />(she的宾格)她；(she的所有格)她的；她，指某个国家，（一
hes	做词根时的意思：<br />	***************<br />做单词时的意思：
hetero	做词根时的意思：<br />异类，异种<br />eg：<br />heterogeneous<br />各种各样的；成分混杂的；<br />heterosexual<br />异性恋的；异性的；  异性恋的人；<br />heterodoxy<br />非正统，异端；	***************<br />做单词时的意思：<br />n.<br />异性恋的，非同性恋[爱]的；<br />adj.<br />异性恋[爱]者；
hexa	做词根时的意思：<br />六<br />eg：<br />hexagon<br />六边形，六角形；	***************<br />做单词时的意思：<br />n.<br />六；
hibit	做词根时的意思：<br />hold,拿住<br />eg：<br />exhibit<br />陈列，展览；呈现；证明；[法]提交证据；  公开展览某物；展出；  展览，陈列；展览品；公开展示；[法]证据；<br />exhibition<br />陈列，展览；展览品，陈列品；表明；[法]（证据等的）提出；<br />inhibit<br />抑制；禁止；	***************<br />做单词时的意思：
holo	做词根时的意思：<br />全部<br />eg：<br />holography<br />全息摄影术，全息术；全息照相；	***************<br />做单词时的意思：<br />abbr.<br />(Latin prefix=entire or whole) （<br />13<br />(Latin prefix=entire or whole) （
homo	做词根时的意思：<br />同类，同源<br />eg：<br />homogeneous<br />同性质的，同类的；由相同（或同类型）事物（或人）组成的；均匀的；<br />homogenize<br />使类同；使…均质；  变均匀；<br />homosexual<br />同性恋者；  同性恋的；	***************<br />做单词时的意思：<br />n.<br /><拉>人，人类（学名）；〈美俚〉同“homosexual”；
horr	做词根时的意思：<br />shudder，dread，颤抖，害怕<br />eg：<br />abhor<br />憎恶；（厌恶地）回避；拒绝；淘汰；  厌恶者，拒绝者；<br />horrible<br />可怕的；极不友好的；极讨厌的；令人震惊的；<br />horrify<br />使震惊，使感到恐怖；	***************<br />做单词时的意思：<br />[人名] 霍尔；
hort	做词根时的意思：<br />encourage，鼓励<br />eg：<br />exhort<br />劝告，劝说；倡导；勉励；<br />hortatory<br />劝告的，激励的；	***************<br />做单词时的意思：<br />abbr.<br />horticulture 园艺；
hum	做词根时的意思：<br />earth,土,地<br />eg：<br />humble<br />谦逊的；简陋的；（级别或地位）低下的；不大的；  使谦恭；轻松打败（尤指强大的对手）；低声下气；<br />humility<br />谦逊，谦恭；谦让的行为；谦虚谨慎；<br />humiliate<br />使蒙羞，使丢脸，使出丑；屈辱，羞辱；	***************<br />做单词时的意思：<br />vt.<br />哼唱；<br />vi.<br />忙碌，活跃；发嗡嗡声；发出嘈杂声；<br />n.<br />嗡嗡声；杂音；哼唱的动作；<br />int.<br />哼；嗯；
hydro	做词根时的意思：<br />water,水<br />eg：<br />anhydrous<br />无水的（尤指结晶水）；<br />dehydrate<br />使脱水，使干燥；  （人体的）脱水，失水；<br />carbohydrate<br />碳水化合物，糖类；淀粉质或糖类食物；	***************<br />做单词时的意思：<br />n.<br />水疗院；
hyper	做词根时的意思：<br />超过，太多<br />eg：<br />hypersensitive<br />过敏的，高度灵敏的；<br />hyperbole<br /><语>夸张法；<br />hypertension<br />高血压；过度紧张；	***************<br />做单词时的意思：<br />n.<br />宣传人员；<br />adj.<br />既兴奋又紧张的；高度紧张的；亢奋的；
hypno	做词根时的意思：<br />sleep，睡眠<br />eg：<br />hypnotic<br />催眠术的；易于催眠的；  安眠药；催眠状态的人；<br />hypnosis<br />催眠，催眠状态，催眠术；<br />hypnology<br />催眠学；	***************<br />做单词时的意思：<br />abbr.<br />hypnotism 催眠术，催眠状态；<br />13<br />hypnotism 催眠术，催眠状态；
hypo	做词根时的意思：<br />下面，次等<br />eg：<br />hypodermic<br />（指药物、注射器等）皮下注射用的；  皮下注射，皮下注射器；<br />hypothesis<br />假设，假说；[逻]前提；<br />hypomnesia<br />记忆力减低；	***************<br />做单词时的意思：<br />n.<br />硫化硫酸钠；海波；<口>刺激；瘾君子；<br />vt.<br />给…作皮下注射；（以皮下注射毒品等方式）刺激；助长；
ideo	做词根时的意思：<br />idea,思想，观点<br />eg：<br />ideology<br />思想（体系），思想意识；意识形态；观念学；空想，空论；<br />ideological<br />思想的；意识形态的；<br />ideograph<br />象形（表意）文字；	***************<br />做单词时的意思：
idol	做词根时的意思：<br />image，形象，偶像<br />eg：<br />idolize<br />将（某人）当作偶像崇拜；<br />idolatrous<br />崇拜偶像的；<br />idolatry<br />偶像崇拜；	***************<br />做单词时的意思：<br />n.<br />偶像，崇拜物；幽灵；谬论；幻觉；
il-	做词根时的意思：<br />不，无<br />eg：<br />illegal<br />不合法的，违法的；违反规则的；  非法移民，非法劳工；间谍；<br />illiterate<br />目不识丁的，文盲的；  目不识丁者；文盲；无知；<br />illogical<br />不合逻辑的；无意义的；	***************<br />做单词时的意思：<br />abbr.<br />Israel 以色列；
im-	做词根时的意思：<br />同in-(后跟辅音字母p、m)时使用，向内，进入<br />eg：<br />impel<br />推动、推进或敦促某人做某事；<br />imperil<br />使陷于危险，危及；<br />impulse<br />凭冲动行事；突如其来的念头；[电子]脉冲；[医]冲动，搏动；  冲动的；  推动；	***************<br />做单词时的意思：<br />abbr.<br />image （公司或商品的）形象；import 进口；imper
imag	做词根时的意思：<br />imagine，想象<br />eg：<br />image<br />影像；肖像；概念，意向；镜像，映像；  反映；想像；作…的像；象征；<br />imagine<br />想，设想；想像；料想，猜想；误认为；  想象；猜想，推测；<br />imaginative<br />富于想像力的，运用想像力的；想象或创造出来的；沉溺于想象的；虚假	***************<br />做单词时的意思：<br />abbr.<br />imaginary 想象中的；假想的；imagination 想
in-	做词根时的意思：<br />向内，进入<br />eg：<br />inborn<br />天生的，先天的，固有的；<br />inaugurate<br />开创；创始；举行开幕典礼；举行就职典礼；<br />incentive<br />动机；刺激；诱因；鼓励；  刺激性的；鼓励性质的；	***************<br />做单词时的意思：<br />prep.<br />采用（某种方式）；穿着，带着；（表示位置）在…里面，（表示领域，<br />adv.<br />在家；进入，到达；流行；当选；<br />adj.<br />在内的，朝内的；在位的，执政的；[口语]流行的，时髦的；（车等）<br />n.<br />执政党，掌权者；知情者；<美口>入口，门路；<体>（板球或棒球）
insul	做词根时的意思：<br />island，表岛屿<br />eg：<br />insular<br />海岛的；孤立的；与世隔绝的；岛民的；<br />insulate<br />使隔离，使孤立；使绝缘，使隔热；<br />insulin<br />胰岛素；	***************<br />做单词时的意思：<br />abbr.<br />insulation 绝缘；
integr	做词根时的意思：<br />whole，完整<br />eg：<br />integral<br />完整的；积分的；必须的；  整体；积分；<br />integrity<br />正直，诚实；完整；[计算机]保存；健全；<br />integrate<br />使一体化；使整合；使完整；使结合成为整体；  成为一体；结合在一起；合并；[数学]作积分运算；  整体的；完整的；完全的；综合的；	***************<br />做单词时的意思：
inter	做词根时的意思：<br />在…之间，相互<br />eg：<br />international<br />国际的；两国（或以上）国家的；超越国界的；国际关系的；  国际组织；国际体育比赛；外国居留者；国际股票；<br />interpersonal<br />人与人之间的；人际的；人与人之间的关系的；涉及人与人之间的关系的<br />interpose<br />插（话）；插入；打断；提出（反对）以便干预；	***************<br />做单词时的意思：<br />vt.<br />埋，葬；
intra	做词根时的意思：<br />在内，向内，内部<br />eg：<br />intranational<br />一国之内的，国内的，民族内的；<br />intrapersonal<br />个人头脑中的，内心的；<br />intraparty<br />政党内的；	***************<br />做单词时的意思：<br />n.<br />在内，内部；
intro	做词根时的意思：<br />向内，入内<br />eg：<br />introduce<br />提出；介绍；引进；作为…的开头；<br />introversible<br />可向内翻的；<br />introspect<br />内省，内观；	***************<br />做单词时的意思：<br />n.<br />介绍；
ir	做词根时的意思：<br />不，无<br />eg：<br />irregular<br />不规则的，不对称的；无规律的；不合规范的，不合法的；不规则变化的 非正规军军人；不规则物；不合规格的产品；<br />irresistible<br />无法抗拒的；诱惑人的，具有非常的魅力的；不可抗拒；不可阻挡；<br />irrevocable<br />不能取消的；不可改变的；不能挽回的；	***************<br />做单词时的意思：<br />abbr.<br />Iran 伊朗；Infra-red 红外线；<br />pref.<br />表否定；
iso	做词根时的意思：<br />等，同<br />eg：<br />isomorphic<br />同形的，同构的；<br />isogeny<br />同源；<br />isotherm<br />等温线；	***************<br />做单词时的意思：<br />abbr.<br />isolation 隔离；in spite of 不管；isol
ject	做词根时的意思：<br />throw,cast,投掷，扔<br />eg：<br />adjective<br />形容词；  形容词的；附属的，不独立的；[法]有关程序的；<br />abject<br />卑鄙的，下贱的；（指境况）凄惨的；轻蔑的，被鄙视的；厚颜无耻的；<br />conjecture<br />推测，猜想；设想，揣度；想像；计划；  推测，猜想；估量；揣摩；设想；	***************<br />做单词时的意思：<br />n.<br />国民住宅（等于project,常出现于黑人的口语和说唱乐中）；
joc	做词根时的意思：<br />joke,笑话<br />eg：<br />jocose<br />闹着玩的，爱开玩笑的，滑稽的；<br />jocular<br />爱开玩笑的；滑稽的，幽默的；<br />jocund<br /><文>欢乐的，愉快的；	***************<br />做单词时的意思：<br />abbr.<br />jocose 开玩笑的；jocosely 开玩笑地；
join	做词根时的意思：<br />结合，连接<br />eg：<br />joint<br />共同的，联合的；共享的；两院的；连带的，共同的；  [解]关节；接合处；下流场所；一块烤肉（英式英语）；  结合，联合；为…装上接头，使…有接缝；<br />adjoin<br />邻近，毗连；接，贴连；附加，使结合；<br />adjoining<br />毗连的，邻近的；  邻近，毗连( adjoin的现在分词 )；	***************<br />做单词时的意思：<br />vt.& vi.<br />连接；联结；加入；参加；<br />vt.<br />结合；参与；上（火车、飞机等）；上（路）；<br />n.<br />连接；结合；接合处；接合点；
journ	做词根时的意思：<br />day，日期<br />eg：<br />journal<br />日报，日志，日记；定期刊物，期刊，杂志；[会计]分类账；<br />journalist<br />新闻工作者，新闻记者；记日志者；<br />journey<br />旅行，旅程行期；历程，过程；  旅行，出游；  在…旅行或旅行到过…；	***************<br />做单词时的意思：<br />abbr.<br />journalism 新闻业；journalist 新闻记者；j<br />13<br />journalism 新闻业；journalist 新闻记者；j
judic	做词根时的意思：<br />judge,判断<br />eg：<br />judicial<br />司法的；法庭的；明断的；公正的；<br />judicious<br />明智的；有见识的；判断正确的；审慎的；<br />prejudice<br />成见，偏见，歧视；侵害；伤害；  使有偏见；不利于，损害；	***************<br />做单词时的意思：
jug	做词根时的意思：<br />yoke，轭,牛轭<br />eg：<br />conjugal<br />婚姻的，夫妻之间的；<br />subjugate<br />征服，降伏；	***************<br />做单词时的意思：<br />n.<br />n.大罐，壶，一大罐（壶）的容量；<br />vt.<br />用陶罐或坛子煮，炖，煨；把…关进监狱；
junct	做词根时的意思：<br />join,结合，连接<br />eg：<br />junction<br />连接，接合；会合点，接合点；（公路或铁路的）交叉路口；（电缆等的<br />juncture<br />时刻，关键时刻；接合点；<br />adjunct<br />附件，助手；  附属的；	***************<br />做单词时的意思：<br />abbr.<br />Junction 接合；
jur	做词根时的意思：<br />swear,law,发誓，法律<br />eg：<br />injury<br />伤害，损害；受伤处；伤害的行为；<br />injurious<br />伤害的；中伤的；不公正的；<br />jury<br />陪审团；（展览会，竞赛等的）全体评审员；舆论的裁决；评判委员会； 应急的；[航]（船上）应急用的；暂时的；	***************<br />做单词时的意思：<br />abbr.<br />juridical 司法的；juridisch (German=
juven	做词根时的意思：<br />young,年轻<br />eg：<br />juvenile<br />少年的；幼稚的，年少无知的；幼稚的；  青少年；扮演少年角色的演员；少年读物；羽毛未丰的鸟，雏鸟；<br />rejuvenate<br />使变得年轻，使恢复活力；  复原，变年轻；<br />rejuvenescent<br />返老还童的，回春的；	***************<br />做单词时的意思：<br />abbr.<br />juvenilized 幼稚的；juvenilization 幼
kilo	做词根时的意思：<br />千，一千<br />eg：<br />kilogram<br />千克；公斤；<br />kilometer<br /><美>千米，公里；<br />kilowatt<br />[电]千瓦；	***************<br />做单词时的意思：<br />n.<br />千克；公斤（等于kilogram）；
labor	做词根时的意思：<br />劳动<br />eg：<br />labored<br />吃力的，谨慎的；  努力争取(for)( labor的过去式和过去分词 )；苦干；详<br />laborious<br />费力的；勤劳的；辛苦的；<br />laboratory<br />实验室；实验课；研究室；药厂；	***************<br />做单词时的意思：<br />n.<br />劳动；努力；工作；劳工；<br />v.<br />努力争取(for)；苦干；详细分析；<br />adj.<br />劳工的，工会的；（常大写）（英国或英联邦国家）工党的；<br />vi.<br />（指引擎）缓慢而困难地运转；
lact	做词根时的意思：<br />milk，奶，乳<br />eg：<br />lactic<br />乳的；	***************<br />做单词时的意思：<br />[医][=labelled antibody competiti<br />0<br />[医][=labelled antibody competiti
langu	做词根时的意思：<br />faint，虚弱<br />eg：<br />languid<br />疲倦的；没精打采的，呆滞的；萧条的；慢吞吞；<br />languish<br />憔悴，潦倒；（草木等）凋萎；失去活力；烦恼，焦思；  憔悴；惹人怜爱的感伤模样[倦态等]；脉脉含情；<br />languor<br />无精打采；倦怠；柔情；惹人爱怜的神色；	***************<br />做单词时的意思：
lapid	做词根时的意思：<br />stone，石头<br />eg：<br />lapidary<br />宝石的；简洁优雅的；刻在石上的；俐落的；  宝石匠，玉石雕刻师；<br />dilapidated<br />残破的，失修的；荒废的，衰败的；破旧；颓；	***************<br />做单词时的意思：<br />abbr.<br />lapidary 宝石商；lapideum (Latin=sto
laps	做词根时的意思：<br />slip,滑,滑走<br />eg：<br />lapse<br />小错，疏忽；行为失检，失足；流逝；[法]（权利等的）失效，消失； 退步；陷入，堕入；失效，终止；[法]转归；<br />collapse<br />折叠；倒塌；崩溃；（尤指工作劳累后）坐下；  使倒塌；使坍塌；使瓦解；  垮台；（身体的）衰弱；<br />elapse<br />消逝；时间过去；  （时间的）消逝；	***************<br />做单词时的意思：<br />n.<br />舔( lap的名词复数 )；一圈；山谷；裙兜；
lat	做词根时的意思：<br />bring,out,拿出,带出<br />eg：<br />translate<br />翻译；解释；转化；被翻译；<br />superlative<br />最高的；最高级的；过度的；  最高级；最好的人；最高程度；<br />collate<br />核对，校对（书、底稿等）；（装钉）整理，检查；[宗]委任牧师职；	***************<br />做单词时的意思：<br />n.<br />1940年前拉脱维亚的货币单位；
later	做词根时的意思：<br />side，边<br />eg：<br />unilateral<br />单边的，一方的；单方有义务的；片面的；仅由一方实行或承担的；<br />lateral<br />侧面的；横向的；[语]边音的；  侧部的东西；边音；	***************<br />做单词时的意思：<br />adv.<br />较晚地；以后，过后；后来；随后；<br />adj.<br />后来的；以后的；接近末期的；晚年的；
lav	做词根时的意思：<br />wash,洗,冲洗<br />eg：<br />lavish<br />过分慷慨的；非常浪费的；过分丰富的；大量生产的；  过分给予，滥施；浪费，挥霍；慷慨地给与；<br />lavatory<br />厕所；盥洗室；<宗>洗礼盆；	***************<br />做单词时的意思：<br />n.<br /><美口>盥洗室；
lax	做词根时的意思：<br />loose，松<br />eg：<br />laxative<br />泻药；[药]缓泻药；  通便的；<br />relax<br />（使）轻松；（使）松弛；放宽；（使）放松；  缓和，减轻；（使大便等）通畅；  变得轻松；变得随和；变得和蔼；通便；<br />relaxation<br />消遣，放松；松懈，松弛；放宽；[生理]驰松；	***************<br />做单词时的意思：<br />adj.<br /><医>（肠）宽松的；松弛的；松懈的；不严格的；<br />n.<br />泻肚；（挪威，瑞典的）鲑；松元音；
lect	做词根时的意思：<br />choose,gather,选择，收集<br />eg：<br />collect<br />收集；收藏；接走；聚积；  募捐；募集；  由受话人付费的；<br />collection<br />收集，采集；征收；收藏品；募捐；<br />collective<br />集体的；共同的；集合的；集体主义的；  [统]集体；[语]集合名词；集团；	***************<br />做单词时的意思：<br />abbr.<br />lectern （教堂中的）读经台，（演讲人放讲稿的）小台架；l
leg	做词根时的意思：<br />speak,read,讲，读<br />eg：<br />legible<br />易读的；<br />illegible<br />难辨认的，字迹模糊的；潦草；<br />allege<br />断言，宣称，辩解；提出…作为理由；	***************<br />做单词时的意思：<br />n.<br />腿；支柱，支架；裤腿；一段赛程；<br />vi.<br /><口>走，跑；
lev	做词根时的意思：<br />raise,lighten,提高,举起,变轻<br />eg：<br />elevate<br />举起；提高；提升；鼓舞；<br />elevator<br />电梯；升降机（美）；谷仓；<br />lever<br />杠杆；操作杆；工具；  用杠杆撬动；	***************<br />做单词时的意思：<br />n.<br />列弗（保加利亚的货币单位）；
lexic	做词根时的意思：<br />word，speech，词汇<br />eg：<br />dyslexia<br />读写困难；<br />lexicographer<br />词典编纂者；<br />lexicon<br />词典；专门词汇；	***************<br />做单词时的意思：<br />adj.<br />词汇的；
liber	做词根时的意思：<br />free,自由<br />eg：<br />liberty<br />自由；许可权；放肆，无礼；解放，释放；<br />liberal<br />自由主义者；自由党党员；  开明的；自由的；慷慨的；不拘泥的；<br />liberate<br />解放；释放；释出，放出；	***************<br />做单词时的意思：<br />n.<br />书籍，登记册；
libr	做词根时的意思：<br />book，书<br />eg：<br />library<br />图书馆，藏书楼；藏书；书屋，书斋；图书出租处；<br />libretto<br />（歌剧等的）剧本；	***************<br />做单词时的意思：<br />abbr.<br />librarian 图书管理员；图书馆管理学专家；library
lic	做词根时的意思：<br />allure，引诱<br />eg：<br />delicate<br />微妙的；熟练的；纤弱的；易损的；<br />delicacy<br />精美；美味佳肴；敏锐，敏感；世故，圆滑；<br />elicit<br />引出，探出；诱出（回答等）；	***************<br />做单词时的意思：<br />abbr.<br />license 许可（证）；执照；low-intensity c
licen	做词根时的意思：<br />allow，允许<br />eg：<br />license<br />许可证，执照；特许；  同意；发许可证；<br />licentious<br />放荡的，淫乱的；猖狂自恣；猖；荒淫；<br />illicit<br />法律不许可的，非法的；不正当的；	***************<br />做单词时的意思：
lig	做词根时的意思：<br />choose,选择，精选的<br />eg：<br />eligible<br />合适的；在（法律上或道德上）合格的；有资格当选的；称心如意的；  合格者；合适者；称心如意的人；合乎条件的人（或东西）；<br />elegant<br />（人或其举止）优美的；漂亮的；简炼的；简洁的；<br />elegance<br />高雅；（举止、服饰、风格等的）优雅；精致物品；（思考等的）简洁；	***************<br />做单词时的意思：<br />vi.<br /><口>闲逛；
lim	做词根时的意思：<br />threshold，门槛，限制<br />eg：<br />eliminate<br />排除，消除；淘汰；除掉；<口>干掉；<br />preliminary<br />初步的，初级的；预备的；开端的；序言的；  准备工作；预赛；初步措施；（对学生等的）预考；<br />subliminal<br /><心>阈下的，潜意识的；太弱或太快以至于难以觉察的；	***************<br />做单词时的意思：<br />abbr.<br />limit(er) 界限；limit-in-the-mean 平
lingu	做词根时的意思：<br />language ,语言，原意为“舌头”<br />eg：<br />linguistics<br />语言学；语言的，语言学的，语言研究的( linguistic的名<br />bilingual<br />双语的，两种语言的，能说两种语言的；  能说两种语言的人；<br />multilingual<br />使用多种语言的；	***************<br />做单词时的意思：
linqu	做词根时的意思：<br />leave，离开<br />eg：<br />delinquent<br />不尽责的，怠工的；有过失的；拖欠债务的；  流氓；少年罪犯；失职者；<br />delinquency<br />不法行为；少年罪犯；过失； 罪过；<br />relinquish<br />放弃；让出（权利，财产等）；放开，松手；撤离；	***************<br />做单词时的意思：
lips	做词根时的意思：<br />leave，离开<br />eg：<br />eclipse<br />[天]（日、月）食；消失，黯然失色；漆黑；  使黯然失色；形成日（或月）食；	***************<br />做单词时的意思：<br />abbr.<br />logical inferences per second 每秒<br />n.<br />嘴唇( lip的名词复数 )；（容器或凹陷地方的）边缘；粗鲁无礼
liqu	做词根时的意思：<br />wet，湿<br />eg：<br />liquid<br />液体；流音；  液体的；清澈的；（声音）流畅的；易转换成现款的；<br />liquor<br />酒，烈性酒；含酒精饮料；  浸泡；喝酒；<br />liquidate<br />清算；清偿；结束；换现款；	***************<br />做单词时的意思：
liter	做词根时的意思：<br />letter,文字,字母<br />eg：<br />literate<br />有读写能力的；有文化修养的；  识字的人；有学问的人；<br />illiterate<br />目不识丁的，文盲的；  目不识丁者；文盲；无知；<br />literacy<br />识字；有文化；能读能写；精通文学；	***************<br />做单词时的意思：<br />n.<br />[计量] 公升（容量单位）；
lith	做词根时的意思：<br />stone,石头<br />eg：<br />neolithic<br />新石器时代的；<br />lithograph<br />平版印刷品；  用平版印刷；<br />lithiasis<br />结石病；	***************<br />做单词时的意思：<br />abbr.<br />lithograph 平版（指石版或金属板）印刷；平版画；lit
loc	做词根时的意思：<br />place,地方<br />eg：<br />local<br />地方的；当地的，本地的；局部的；褊狭的；  慢车；本地居民（律师、教士、医生）；住处附近的当地酒店；本地新闻<br />locality<br />位置；地区；产地；<br />locate<br />位于；说出来源；查找…的地点；确定…的位置；  定位；定居；	***************<br />做单词时的意思：<br />abbr.<br />通信线路 （Lines of Communication）；<br />地方；代码行；(俚)疯狂的；<br />n.<br />(Loc)人名；(塞)洛茨；(越)禄；
log	做词根时的意思：<br />speak,说话<br />eg：<br />logic<br />逻辑，逻辑学；（做某事的）道理；推理方法；威力，压力，强制（力） 逻辑的；<br />logical<br />逻辑（上）的；符合逻辑的；推理正确的；合乎常理的；<br />analogy<br />类似，相似；比拟，类比；类推；	***************<br />做单词时的意思：<br />n.<br />记录；日志；原木；<br />v.<br />伐木；把…载入正式记录；行驶；
loqu	做词根时的意思：<br />speak,说话<br />eg：<br />loquacious<br />爱说话的，多嘴的；嘴碎；贫嘴；<br />colloquial<br />口语的，会话的；<br />colloquy<br />谈话，对话；	***************<br />做单词时的意思：
luc	做词根时的意思：<br />light,shine,光,照亮<br />eg：<br />lucid<br />清楚的，明白的；神志清醒的；清澈的，透明的；[动，植]光滑的；<br />elucidate<br />阐明，解释；<br />translucent<br />半透明的；透亮的，有光泽的；	***************<br />做单词时的意思：<br />[医][=large unstained cell]不染色大细胞
lud	做词根时的意思：<br />play,玩，戏剧<br />eg：<br />allude<br />暗指；间接提到；<br />delude<br />欺骗，哄骗；<br />delusion<br />欺骗；谬见；错觉；妄想；	***************<br />做单词时的意思：<br />n.<br /><英>封建领主；地主；统治者；上帝；
lumin	做词根时的意思：<br />light,光<br />eg：<br />illuminate<br />照亮，照明；阐明，说明；装饰；使灿烂；  照亮；<br />illumination<br />照明；阐明，解释清楚；<物>照度；彩饰，图案花饰；<br />luminary<br />杰出人物，名人；天体；发光体；	***************<br />做单词时的意思：
lun	做词根时的意思：<br />moon，月亮<br />eg：<br />lunar<br />月的，月球的；阴历的；（光）苍白的，微弱的；银的，含银的；	***************<br />做单词时的意思：<br />abbr.<br />lundi (French=Monday) （法语）星期一；lu<br />13<br />lundi (French=Monday) （法语）星期一；lu
lust	做词根时的意思：<br />light,shine,光,照亮<br />eg：<br />lusty<br />健壮的，强壮的；又高又粗；<br />lackluster<br />无光泽，暗淡；  无光泽的，暗淡的；<br />lustrous<br />光亮的，有光泽的；  光亮地，有光泽地；  光亮，有光泽；	***************<br />做单词时的意思：<br />n.<br />强烈的性欲；肉欲，色情；强烈的欲望；渴望，热烈追求；<br />vi.<br />贪求；渴望；好色；
lustr	做词根时的意思：<br />light，光亮<br />eg：<br />lackluster<br />无光泽，暗淡；  无光泽的，暗淡的；<br />illustrate<br />说明；表明；给…加插图；（用示例、图画等）说明；  举例说明；	***************<br />做单词时的意思：
lut	做词根时的意思：<br />wash,洗,冲洗<br />eg：<br />ablution<br />净身礼；（常用复数）沐浴；洗礼水；<英>（军营中的）公共浴室；<br />dilute<br />稀释，冲淡；  稀释的，冲淡的；<br />deluge<br />洪水；泛滥；倾盆大雨；  使淹没；使泛滥；	***************<br />做单词时的意思：<br />abbr.<br />launcher umbilical tower 发射器控制塔；
luv	做词根时的意思：<br />wash,洗,冲洗<br />eg：<br />antediluvian<br />(<圣经>上说的)大洪水以前的；<口>非常古老的；  大洪水以前的人或事物；年迈的人；老朽；远远落后于时代的人；<br />diluvial<br />冲积的，大洪水的；	***************<br />做单词时的意思：<br />n.<br />爱，爱情；
lys	做词根时的意思：<br />break bown，裂开，分解<br />eg：<br />analysis<br />分析，分解；梗概，要略；[数]解析；验定；<br />analyze<br /><美>分析；分解；解释；对…进行心理分析；<br />catalyst<br /><化>触媒，催化剂；〈比喻〉触发因素；促进因素；〈口〉有感染力的	***************<br />做单词时的意思：<br />abbr.<br />lysine 赖氨酸；
mach	做词根时的意思：<br />machine，机器<br />eg：<br />machine<br />机器，机械；机械般的人；核心；  用机器制造，用机器加工；  被机器切削；	***************<br />做单词时的意思：<br />abbr.<br />machine 机器；machinery 机器；machinis
macro	做词根时的意思：<br />宏伟，大<br />eg：<br />macroclimate<br />大气候；<br />macrobian<br />长寿的；  长寿的人；<br />macroscale<br />大规模，宏观尺度；	***************<br />做单词时的意思：<br />n.<br />[自]宏指令；巨（计算机术语）；<br />adj.<br />巨大的；大量使用的；特别突出的；极厚的；
main	做词根时的意思：<br />stay，逗留<br />eg：<br />remain<br />剩余物，残骸；残余；遗迹；遗体；  留下；保持；留待；依然；  搁置；剩余，剩下；逗留；终属，归于；<br />remainder<br />剩余物；其他人员；差数；廉价出售的图书；  廉价出售（书）；廉价出售；  剩余的；留存下的；<br />maintain<br />保持；保养；坚持；固执己见；	***************<br />做单词时的意思：<br />adj.<br />主要的，最重要的；全力的；<br />n.<br />最主要的部分，重点；主要管道；体力；[航海]公海；
maj	做词根时的意思：<br />great，大，伟大<br />eg：<br />majority<br />多数；（获胜的）票数；成年；法定年龄；<br />majestic<br />宏伟的；壮丽的；庄重的；磅礴；<br />mayor<br />市长；镇长；（英格兰、威尔士和北爱尔兰由议员选举产生的）镇长；（	***************<br />做单词时的意思：<br />abbr.<br />major （美）主修课；成年人；大调；majority （大）
mal	做词根时的意思：<br />坏，恶<br />eg：<br />malcontent<br />不满者；  不满的；<br />malpractice<br /><律>玩忽职守；[医]治疗不当，滥治；弊端；藏掖；<br />malediction<br />诅咒，咒骂；	***************<br />做单词时的意思：<br />n.<br /><法>病，疾病，不适；
man	做词根时的意思：<br />hand,手<br />eg：<br />manage<br />使用；完成（困难的事）；经营；明智地使用（金钱、时间、信息等）； 办理，设法对付；  能解决（问题）；应付（困难局面等）；凑合着活下去；支撑；<br />manacle<br />手铐；  给…带上手铐；<br />manual<br />用手的；手制的，手工的；[法]占有的；体力的；  手册；指南；[乐]键盘；[军]刀枪操练；	***************<br />做单词时的意思：<br />n.<br />男人；人类；男子汉；雇工；<br />vt.<br />使振作；操纵；给…配置人员；在…就位；<br />int.<br />（表示惊讶、气愤等）嘿，天哪；
mand	做词根时的意思：<br />order，命令<br />eg：<br />mandate<br />授权；任期；委任；命令；  托管；批准；  强制执行；委托办理；<br />demand<br />要求，请求；需要；[法]召唤；询问，盘问；  需求；需要；要求，请求；销路；  需要；请求；查问；<br />countermand<br />取消（命令），撤回；	***************<br />做单词时的意思：<br />n.<br />祈使语（指以产生某种特定效果为目的的话语）；
marin	做词根时的意思：<br />sea,海洋<br />eg：<br />marine<br />海的；海产的；海军的；海事的；  水兵；海军陆战队士兵；海事，海运业；<br />mariner<br />海员，水手；<br />submarine<br />潜艇；海底生物；  水下的，海底的；  用潜艇攻击；  驾驶潜艇；划入底下；	***************<br />做单词时的意思：<br />n.<br />海风（地中海）；
mark	做词根时的意思：<br />sign ,记号，符号<br />eg：<br />marked<br />显著的，著名的；有记号的；加印记的；受监视的；  表示(mark的过去分词)；作记号；给…打分；在…留下痕迹；<br />remark<br />注意，观察；话语；评论，谈论，；  评论；觉察；<br />remarkable<br />异常的，引人注目的，；卓越的；显著的；非凡的，非常（好）的；	***************<br />做单词时的意思：<br />n.<br />斑点；记号；成绩；标准；<br />vt.<br />作记号；表示；给…打分；在…留下痕迹；<br />vi.<br />评分；注意；（比赛中）记分；
matern	做词根时的意思：<br />mother, 母性，母亲<br />eg：<br />maternal<br />母亲的；母亲般的；母系的；母亲方面的；<br />maternity<br />母性，为母之道；妇产科医院；  产妇用的；产科的；孕妇的；	***************<br />做单词时的意思：<br />abbr.<br />maternal 母亲的；似母亲的；maternity 母性；母
matr	做词根时的意思：<br />母，女性<br />eg：<br />matronage<br />主妇的身份，主妇们；<br />matriarchy<br />女性统治的社会组织形态，母权制，母系氏族制；<br />matron<br />（受人尊敬的）已婚老妇人；夫人；女看守；女警卫；	***************<br />做单词时的意思：<br />abbr.<br />matter 事情，问题，情况；
mech	做词根时的意思：<br />machine，机器<br />eg：<br />mechanic<br />技工，机修工；	***************<br />做单词时的意思：<br />abbr.<br />mechanics 机械；mechanical 机械的；mech
med	做词根时的意思：<br />middle,中间<br />eg：<br />mediate<br />经调解解决；斡旋促成；  调停，调解，斡旋；  居间的，间接的；<br />mediator<br />调停者；调解人；传递者；中介物；<br />immediate<br />立即的；直接的，最接近的；目前的，当前的；直觉的；	***************<br />做单词时的意思：<br />abbr.<br />medicine 医学；medium 中间；medical 医学
mend	做词根时的意思：<br />改错<br />eg：<br />amend<br />改良，修改；修订；<br />amendment<br />修正案；修改，修订；<br />emend<br />校订，修改；	***************<br />做单词时的意思：<br />vt.<br />修理，修补；改正，纠正；加强；使恢复健康；<br />vi.<br />康复，痊愈；修理，矫正；<br />n.<br />修补；补丁；痊愈；
ment	做词根时的意思：<br />mind,思考，神智<br />eg：<br />mention<br />提到，说起；提名表扬；  提及；<br />comment<br />评论；注释；意见；说明；  评论，谈论；  表达意见；解释，注释；  作注释；作注解；作解释；作评语；<br />demented<br />疯狂的，精神错乱的；  精神错乱，变得痴呆（dement的过去分词）；	***************<br />做单词时的意思：<br />abbr.<br />mention 提到；mental 精神的；mentalis 精
merc	做词根时的意思：<br />trade，交易<br />eg：<br />commerce<br />商业；商务；贸易；<br />commercial<br />商业的；贸易的；营利的；靠广告收入的；  （电台或电视播放的）广告；<br />mercenary<br />雇用的；图利的，唯利是图的；  雇佣兵；唯利是图者；	***************<br />做单词时的意思：<br />n.<br /><口>外国雇佣兵；
merg	做词根时的意思：<br />sink,沉，没<br />eg：<br />emerge<br />出现，浮现；暴露；摆脱；<br />emergence<br />出现，发生；暴露；[植]突出体，（柑果的）瓤胞；<br />emergency<br />紧急情况；突发事件；非常时刻；  紧急的，应急的；	***************<br />做单词时的意思：<br />[医][=macular electroretinogram]视
mers	做词根时的意思：<br />sink,沉，没<br />eg：<br />immerse<br />浸没；施浸礼；沉迷…中，陷入；<br />submersed<br />生长水中的，浸没的，淹没的；  使沉入水中，淹没( submerse的过去式和过去分词 )；<br />submersion<br />淹没；	***************<br />做单词时的意思：<br />[计]= Multi-Element Radiometer Sy
meta	做词根时的意思：<br />超过，改变<br />eg：<br />metabolism<br />新陈代谢；代谢作用；<br />metaphor<br />隐喻，暗喻；象征；<br />metaphysis<br />干骨后端；	***************<br />做单词时的意思：<br />abbr.<br />(Greek=after or beyond) （希腊语）在…之
meter	做词根时的意思：<br />measure,计量(工具)，测量<br />eg：<br />barometer<br />气压计；晴雨表；显示变化的事物；<比喻>（舆论等的）标记；<br />diameter<br />直径，直径长；放大率；<br />perimeter<br /><数>周长；周围，边界；	***************<br />做单词时的意思：<br />n.<br />计量器；计量仪；<br />v.<br />用仪表测量；
micro	做词根时的意思：<br />微，小<br />eg：<br />microscope<br />显微镜；<br />microwave<br />微波；微波炉；  用微波炉加热（或烹饪）；<br />microbe<br />微生物，细菌；	***************<br />做单词时的意思：<br />n.<br /><口>微型计算机；微处理器；<br />adj.<br />极小的；
migr	做词根时的意思：<br />remove,迁移<br />eg：<br />migrate<br />迁移，移往；移动；随季节而移居；  使移居；使移植；<br />migratory<br />迁移的；有迁居习惯（或特色）的；流浪的；<医>游走性的；<br />migrant<br />候鸟；移居者，移民；随季节迁移的工作者；迁移动物；  移居的；流浪的；同“migratory”；	***************<br />做单词时的意思：
milit	做词根时的意思：<br />soldier，兵<br />eg：<br />militant<br />斗志昂扬的，富于战斗性的；激进的，好战的；战斗中的，交战中的；好 激进分子，好斗分子；富有战斗精神的人，斗士；<br />military<br />军事的；军用的；讨厌的；好战的；  军人；军队；武装力量；<br />militia<br />民兵组织，民兵；	***************<br />做单词时的意思：<br />abbr.<br />military 军事的，军用的；militia 民兵；<br />13<br />military 军事的，军用的；militia 民兵；
milli	做词根时的意思：<br />千，千分之一<br />eg：<br />millimeter<br />毫米；<br />millennial<br />一千年的，千福年的；	***************<br />做单词时的意思：<br />[计] 毫；千分之一；
min	做词根时的意思：<br />project,伸出，突出<br />eg：<br />eminent<br />（指人）知名的，杰出的，卓越的；（指品质、特性）明显的，显着的，<br />eminence<br />显赫，卓越；身份显赫的人；高地；<br />imminent<br />（通常指不愉快的事）即将发生的；迫切的，危急的；逼近的；迫在眉睫	***************<br />做单词时的意思：<br />abbr.<br />minute 分；minuto (Portuguese or S
mini	做词根时的意思：<br />小<br />eg：<br />miniature<br />小型的，微小的；  微型复制品；微小模型；微型画；微型人像画；  使成小型；把…画成纤细画；缩写；<br />minimal<br /><正式>最小的，极少的；极小的；  最简单派艺术作品；<br />minimum<br />最低限度；最小量；最低消费；[数]极小值；  最低的；最小的；最少的；	***************<br />做单词时的意思：<br />n.<br />袖珍型的东西；微型汽车；微型电脑；迷你短裙；<br />adj.<br />袖珍的，微型的；（裙）超短的；
mir	做词根时的意思：<br />wonder,look,惊奇，看<br />eg：<br />mirror<br />镜子，反光镜；真实的写照；反映，借鉴；榜样；  反映；反射；<br />miracle<br />奇迹，圣迹，神迹；令人惊奇的人（或事）；<br />miraculous<br />奇迹般的；不可思议的；神奇；	***************<br />做单词时的意思：<br />n.<br />米尔（沙俄时代的一种村社组织）；
mis	做词根时的意思：<br />错误，坏<br />eg：<br />mistake<br />错误，过失，误解；差错，口误，笔误；失策，失误；  弄错，误解；  认不出；误会；看错；  弄错；误解；<br />misfortune<br />不幸；厄运；不幸的事；灾难；<br />mistrust<br />不信任；怀疑；  不信任；	***************<br />做单词时的意思：<br />abbr.<br />miscarriage 失败；mistake(n) 误解；met
misc	做词根时的意思：<br />mix,混淆<br />eg：<br />nonmiscible<br />不混合的，不容易混合的；<br />immiscible<br />不能混合的，不融和的；<br />miscible<br />易混合的；	***************<br />做单词时的意思：<br />adj.<br />各色各样混在一起，混杂的，多才多艺的；
miser	做词根时的意思：<br />wretched,可怜的<br />eg：<br />miser<br />守财奴，吝啬鬼，〈古〉可怜的人；（矿山，凿井用）钻孔机，凿井机，<br />miserable<br />悲惨的；令人痛苦的；太少的；卑鄙的；<br />misery<br />痛苦；不幸；穷困；悲惨的境遇；	***************<br />做单词时的意思：<br />n.<br />守财奴，吝啬鬼，〈古〉可怜的人；（矿山，凿井用）钻孔机，凿井机，
miso	做词根时的意思：<br />hate，恨<br />eg：	***************<br />做单词时的意思：<br />n.<br />日本豆面酱；
miss	做词根时的意思：<br />send,cast,送，放出<br />eg：<br />mission<br />代表团；使命；官方使命；布道所；  给…交代任务；派遣；把任务交给；向…传教；<br />missionary<br />传教士；宣传者；  传教（士）的；<br />commission<br />委员会，委员；[商]佣金，手续费；任命，委任；委任状；  委任，授予；使服役；使（船）服役；	***************<br />做单词时的意思：<br />n.<br />（用于姓名或姓之前，对未婚女子的称呼）小姐；女士；失误；<br />v.<br />漏掉；错过（机会）；思念；没遇到；
mit	做词根时的意思：<br />send,cast,送，放出<br />eg：<br />admit<br />许可进入；承认，供认；  允许；确认；  承认；允许；<br />commit<br />犯罪，做错事；把…托付给；保证（做某事、遵守协议或遵从安排等）；<br />committee<br />委员会；	***************<br />做单词时的意思：<br />abbr.<br />mitomycin 丝裂霉素（抗肿瘤药）；market if t
mnes	做词根时的意思：<br />remember，记忆<br />eg：<br />amnesia<br /><医>遗忘（症），记忆缺失；善忘；易忘症；健忘；<br />amnesty<br />大赦，特赦；  对…实行大赦；赦免；	***************<br />做单词时的意思：
mob	做词根时的意思：<br />move,动，移动<br />eg：<br />mobile<br />可移动的；行动自如的；易变的；流动性的；  风铃；手机；<br />immobile<br />固定的；不变的；稳定的；<br />mobility<br />流动性；移动性；<社>流动；机动性；	***************<br />做单词时的意思：<br />n.<br />暴徒；犯罪团伙，黑手党；民众，乌合之众；〈美俚〉匪帮，一群罪犯；<br />vt.<br />聚众包围；大举包围，围攻；蜂拥进入；
mod	做词根时的意思：<br />mode,manner,方式，模式，风度<br />eg：<br />modest<br />谦虚的，谦逊的；适度的，适中的；端庄的；羞怯的；<br />moderate<br />有节制的；稳健的，温和的；适度的，中等的；<美俚>慢吞吞的；  使和缓；主持；节制；  变缓和；作主持人；<br />modify<br />被修饰；修改；  改变；减轻，减缓；[语]修饰，（用变音符号）改变；	***************<br />做单词时的意思：<br />n.<br />摩登派；现代派分子；<br />adj.<br />现代派的；新潮的；极时髦的；<br />abbr.<br />现代的（等于modern）；修改（等于moderate）；模数，
moll	做词根时的意思：<br />soft，软<br />eg：<br />mollify<br />使变软，使平静，抚慰；	***************<br />做单词时的意思：<br />n.<br />盗贼或流氓的姘妇；
mon	做词根时的意思：<br />warn,警告<br />eg：<br />monitor<br />显示屏，屏幕；[计]显示器；监测仪；监控人员，班长；  监控，监听；搜集，记录；测定；监督；  监视；<br />admonish<br />劝告；训诫；（温和地）责备；轻责；<br />premonition<br />预感，预兆；前兆，征兆；预先的警告（告诫），预诫；	***************<br />做单词时的意思：<br />n.<br />男人，人类，人；
mono	做词根时的意思：<br />单个，一个<br />eg：<br />monarch<br />君主，帝王；最高统治者；[动]黑脉金斑蝶；<br />monogamy<br />一夫一妻制；<br />monologue<br />（戏剧）独白；独角戏；长篇大论；	***************<br />做单词时的意思：<br />adj.<br />单声道的；
monstr	做词根时的意思：<br />show,显示<br />eg：<br />monster<br />巨大的，庞大的；（建筑物）巍峨的；  怪物；恶魔，恶人；庞然大物；畸形，畸胎；<br />monstrous<br />丑陋的；巨大的；畸形的；与传说中怪物相象的；<br />demonstrate<br />证明，证实；论证；显示，展示；演示，说明；  示威游行；	***************<br />做单词时的意思：
mor	做词根时的意思：<br />moral，道德<br />eg：<br />moral<br />道德的，道义上的；精神上的；无疑的，当然的；教导道德的；  寓意，教训；（尤指男女间的）品行；格言；〈古〉相对者；<br />morale<br />士气；精神面貌；<br />demoralize<br />使士气低落，使意志消沉；使陷入混乱；	***************<br />做单词时的意思：<br />n.<br />粗腐殖质；
mord	做词根时的意思：<br />bite,咬<br />eg：<br />mordant<br />（指讽刺等）刻薄的；尖锐的；刺痛的；腐蚀的；  媒染剂，酸洗剂；  媒染，用媒染剂处理；	***************<br />做单词时的意思：<br />abbr.<br />Magneto-Optical Rotatary Dispers
morph	做词根时的意思：<br />form,shape,形状<br />eg：<br />morphology<br />形态学（尤指动植物形态学或词语形态学）；<br />amorphous<br />无组织的；模糊的；无固定形状的；非结晶的；<br />anthropomorphous<br />人形的；	***************<br />做单词时的意思：<br />n.<br />（动植物的）变种；变体；语子；语素形式；<br />vt.<br />在屏幕上变换图像；改变；
mort	做词根时的意思：<br />death,死<br />eg：<br />mortal<br />致命的；不共戴天的；终有一死的；极度的；  凡人，人类；<br />immortal<br />不死的；永恒的，不朽的；神的；流芳百世的；  神仙；流芳百世的人；不朽的作家；<br />mortality<br />死亡数，死亡率；必死性，必死的命运；	***************<br />做单词时的意思：<br />n.<br />通知猎物已死的号角声，大量，许多；
mot	做词根时的意思：<br />动<br />eg：<br />motion<br />运动；手势；动机，意向；请求；  打手势；向某人点头或摇头示意；打手势要求[指示]；  运动；打手势；<br />motive<br />动机，主旨；（艺术作品的）主题，题材；  运动的；动机的；发动的；  促使；<br />motivate<br />使有动机，促动，激发，诱导；刺激；激发…的积极性；	***************<br />做单词时的意思：<br />n.<br />警句；
mount	做词根时的意思：<br />scend,登上<br />eg：<br />mountain<br />山，山岳；山脉；一大堆；大量；<br />mountainous<br />多山的；巨大的；山一般的；<br />surmount<br />战胜，克服；登上，攀登；居于…之上；顶上覆盖着；	***************<br />做单词时的意思：<br />vt.& vi.<br />登上；骑上；<br />vi.<br />增加；上升；<br />vt.<br />安装，架置；镶嵌，嵌入；准备上演；成立（军队等）；<br />n.<br />山峰；攀，登；运载工具；底座；
multi	做词根时的意思：<br />多,很多<br />eg：<br />multiple<br />多重的；多个的；复杂的；多功能的；  <数>倍数；[电工学]并联；连锁商店；下有多个分社的旅行社；<br />multiply<br />乘；（使）相乘；（使）增加；（使）繁殖；  多样地；复合地；多倍地；[电学]并联地，多路地；  多层的；多样的；多股的；<br />multitude<br />大量，许多；大众，人群；	***************<br />做单词时的意思：<br />abbr.<br />(Latin prefix=many or much) （拉丁语
mun	做词根时的意思：<br />public,公共的<br />eg：<br />municipal<br />市的，市政的；地方自治的；都市的，市营的，市制的；内政的；  市政债券；<br />municipality<br />自治市；市政当局；<br />commune<br />公社；亲密的会谈；  交谈，谈心；密切联系；<美>接受圣餐；	***************<br />做单词时的意思：<br />abbr.<br />municipal 市的；自治城市的；地方自治的；municip
mur	做词根时的意思：<br />wall,墙壁<br />eg：<br />mural<br />（通常指大型的）壁画；  墙壁的，墙的；画在或者挂在墙上的；<br />immure<br />禁闭，监禁；<br />extramural<br />市外的，单位以外的，校际比赛的；	***************<br />做单词时的意思：<br />[医][=muriaficus]（拉）盐酸盐；
mus	做词根时的意思：<br />muse,娱乐，快乐，来自希腊神话“缪斯”文艺音乐女神<br />eg：<br />music<br />音乐；乐曲；乐谱；乐队；<br />musician<br />音乐家；<br />amuse<br />使人发笑；逗乐；使消遣；娱乐；	***************<br />做单词时的意思：<br />[医][=mouse]小鼠，鼠；
mut	做词根时的意思：<br />change,改变<br />eg：<br />mutate<br />（使某物）变化；改变；突变；变异；<br />mutinous<br />反抗的，叛变的；  反抗地，叛变地；  反抗，叛变；<br />mutual<br />共有的；共同的；相互的；彼此的；	***************<br />做单词时的意思：<br />n.<br /><俚>狗；杂种狗；傻瓜；无足轻重的人；
nat	做词根时的意思：<br />born,出生<br />eg：<br />natal<br />出生的，出生时具有的，先天的；<br />innate<br />天生的；特有的，固有的；内在的，直觉的；<br />nation<br />国家；民族；国民；政府；	***************<br />做单词时的意思：<br />n.<br />（缅甸人、泰国人信奉的）守护神，精灵，神怪；奈特；
naut	做词根时的意思：<br />ship, 船，引申为“海员<br />eg：<br />astronaut<br />宇航员；太空人；航天员；<br />nautical<br />海上的，航海的；船舶的；海员的，水手的；<br />astronautics<br />太空航空学；	***************<br />做单词时的意思：<br />abbr.<br />nautical 船员的，航海的，海军的；<br />13<br />nautical 船员的，航海的，海军的；
nav	做词根时的意思：<br />ship, 船<br />eg：<br />navy<br />海军；船队；<br />naval<br />（有）海军的，军舰的，船的；<br />navigate<br />驾驶；航行于；使通过；  驾驶；航行；	***************<br />做单词时的意思：<br />abbr.<br />navigate 航行；navigation 航海；naviga
nect	做词根时的意思：<br />bind, 连结<br />eg：<br />connect<br />连接，联结；使…有联系；为…接通电话；插入插座；  连接；建立关系；[体]成功击中；<br />connection<br />连接；联系，关系；连接点；亲戚；<br />disconnect<br />切断；断开；拆开；使（电话线路）中断；	***************<br />做单词时的意思：<br />abbr.<br />non-enhanced CT scan 非增强计算机断层扫描；
neg	做词根时的意思：<br />deny, 否认<br />eg：<br />neglect<br />疏忽；忽略；遗漏；疏于照顾；  玩忽；被忽略的状态；怠慢；<br />negligible<br />可以忽略的；微不足道的；无足轻重的；不足轻重；<br />negligence<br />疏忽；[法]过失；粗心大意；	***************<br />做单词时的意思：<br />abbr.<br />negative 否定的；
negr	做词根时的意思：<br />black,黑<br />eg：<br />negrophobe<br />畏惧黑人的人；<br />negro<br />National Economic Growth and Rec	***************<br />做单词时的意思：
neo	做词根时的意思：<br />新的<br />eg：<br />neolithic<br />新石器时代的；<br />neologism<br />新词；旧词新义；新词[新义]的使用；新词[新义]的创造者[使用者<br />neoteric<br />近代的，新发明的；  现代人，现代作家；	***************<br />做单词时的意思：<br />[计] 最新式；
neur	做词根时的意思：<br />神经<br />eg：<br />neurology<br /><医>神经病学；<医>神经病学家；  <医>神经病学的；<br />neuritis<br />神经炎；<br />neural<br />神经的；背的，背侧的；	***************<br />做单词时的意思：<br />[医]神经元；<br />0<br />[医]神经元；
nex	做词根时的意思：<br />bind, 连结<br />eg：<br />nexus<br />（事物、思想等之间的）联结，联系，关系；<br />annex<br />附加，追加；吞并（国家、地区等），兼并；获得，得到；  附录；附属物（品），附件；附属建筑；<br />connexion<br />联系，连结；	***************<br />做单词时的意思：<br />自鼻到耳到剑突；
nigr	做词根时的意思：<br />black,黑<br />eg：<br />denigrate<br />诋毁，诽谤；玷污；涂黑；毁誉；<br />denigration<br />弄黑；诋毁；贬低；抹黑；  [医] 涂黑，变黑；<br />nigritude<br />黑，漆黑；	***************<br />做单词时的意思：
nihil	做词根时的意思：<br />nothing，无，不存在<br />eg：<br />annihilate<br />歼灭，毁灭；使消失；彻底击败，战胜；使无效，使废弃；  湮灭，湮没；<br />nihilism<br />虚无主义，极端怀疑论；	***************<br />做单词时的意思：<br />n.<br />无，虚无；
noc	做词根时的意思：<br />hurt, poison, 伤害，毒<br />eg：<br />innocent<br />无辜的，无罪的；清白的；天真无邪的；无知的；  无辜者；头脑简单的人；天真无邪的人；<br />innocence<br />清白；天真无邪；无罪的人；<br />innocuous<br />无害的；平淡无味的；	***************<br />做单词时的意思：<br />abbr.<br />nociceptin 痛敏肽；nopaline cataboli
noct	做词根时的意思：<br />night，夜晚<br />eg：<br />noctilucent<br />生物发光的，夜发光的；夜光；<br />nocturnal<br />夜的，夜间的；（动物）夜间活动的；（植物）夜间开花的；[乐]夜曲<br />nocturne<br />夜曲，夜景；	***************<br />做单词时的意思：<br />abbr.<br />nocte (Latin=by night, nocturnal
nomin	做词根时的意思：<br />name,名称，名字<br />eg：<br />nominal<br />名义上的；微不足道的；票面上的；名字的，列名的；  名词性词；<br />nominate<br />提名…为候选人；任命；挑选；指定（时间、日期、名称等）；<br />denominate<br />命名，称呼；	***************<br />做单词时的意思：<br />abbr.<br />nominative 主格（的）；
non	做词根时的意思：<br />不，非<br />eg：<br />nonconformist<br />（不信奉英国国教的）新教徒；不墨守成规者；  不墨守成规的；形容词（英国）不信奉英国国教的；不遵奉圣公会的；<br />nonstop<br />直达的；不停的；不休息的；不断的；  直达地；不停地；不休息地；不断地；  直达车，班机；<br />nonexistent<br />不存在的；	***************<br />做单词时的意思：<br />adv.<br />非，不；<br />n.<br />[法]反对票，投反对票的人；
norm	做词根时的意思：<br />rule, 规则，规范<br />eg：<br />norm<br />标准；规范；准则；（劳动）定额；<br />abnormal<br />反常的，异常的；不规则的；变态的，畸形的；邪门儿；<br />enormous<br />巨大的；庞大的；极恶的；凶暴的；	***************<br />做单词时的意思：<br />n.<br />标准；规范；准则；（劳动）定额；
nost	做词根时的意思：<br />home，家<br />eg：<br />nostalgia<br />对往事的怀恋；怀旧；乡愁；怀乡病；<br />nostrum<br />骗人的疗法，有专利权的药品；妙策；<br />nostomania<br />怀乡病，怀旧；怀乡狂；	***************<br />做单词时的意思：<br />abbr.<br />National Institute of Science an
not	做词根时的意思：<br />know,知道，注意<br />eg：<br />notable<br />值得注意的；显著的；著名的；  名人；显要人物；<br />notice<br />注意；布告；警告；预告；  注意；  通知；留心；关照；注意到；  引起注意；<br />notify<br />通知；布告；	***************<br />做单词时的意思：<br />adv.<br />不；[用以表示否定、否认、拒绝、禁止等]不是；几乎不；未必，没有
nounce	做词根时的意思：<br />speak,讲话，说出<br />eg：<br />announce<br />宣布参加竞选；当播音员；  宣布；述说；声称；预告；<br />announcement<br />通告；布告；预告；宣告；<br />denounce<br />公开指责；正式指控；告发；通告废除；	***************<br />做单词时的意思：
nov	做词根时的意思：<br />new,新的<br />eg：<br />novel<br />（长篇）小说；[法]新法，附律；  新奇的；异常的；<br />novelty<br />新奇；新奇的事物；新颖小巧而价廉的物品；<br />nova<br />新星；	***************<br />做单词时的意思：<br />abbr.<br />novel 小说；novelist 小说家；novum (Lat
null	做词根时的意思：<br />none，没有<br />eg：<br />nullify<br />虚假说，零假说；  使抵消；使无效；<br />annul<br />宣告无效；取消；使消失；抹去；<br />null<br /><术>零值的；等于零的；（协议） 无法律效力；失效的；	***************<br />做单词时的意思：<br />adj.<br /><术>零值的；等于零的；（协议） 无法律效力；失效的；
numer	做词根时的意思：<br />number,数目<br />eg：<br />numerous<br />很多的，许多的；数量庞大的数量庞大的；数不清的；<br />enumerate<br />列举，枚举，数；<br />innumerable<br />无数的，数不清的；指不胜屈；不可胜数；无可胜数；	***************<br />做单词时的意思：<br />abbr.<br />numeral 数字；numerical 数字的；<br />13<br />numeral 数字；numerical 数字的；
nutri	做词根时的意思：<br />nourish，营养<br />eg：<br />nutrition<br />营养，滋养；营养品；营养学；食物；<br />malnutrition<br />营养不良；<br />nutrient<br />营养物，营养品，养分，养料；滋养物；  营养的，滋养的；	***************<br />做单词时的意思：
ob	做词根时的意思：<br />逆，倒，加强意义<br />eg：<br />oblique<br />斜，倾斜的；[数]非直角的，非垂直的，斜角，斜面；拐弯抹角的，间 倾斜；  倾斜物；<br />obscure<br />昏暗的，朦胧的；晦涩的，不清楚的；隐蔽的；不著名的，无名的；  使…模糊不清，掩盖；隐藏；使难理解；  某种模糊的或不清楚的东西；<br />obsolete<br />废弃的；老式的，已过时的；[生]已废退的；  废词；被废弃的事物；  淘汰；废弃；	***************<br />做单词时的意思：<br />abbr.<br />(Latin prefix=against, infront o
octa	做词根时的意思：<br />八，（亦作octo）<br />eg：	***************<br />做单词时的意思：<br />[医]八，辛；
octo	做词根时的意思：<br />八，（亦作octa）<br />eg：<br />October<br />十月；<br />octagon<br /><几>八边形，八角形；	***************<br />做单词时的意思：<br />[医]八，辛；
omni	做词根时的意思：<br />全部，到处<br />eg：<br />omnipresent<br />无所不在的，同时遍在的；无往不在；<br />omnipotent<br />全能的，权力无限的；  全能者；<br />omniscient<br />无所不知的；	***************<br />做单词时的意思：<br />n.<br />座席；[医]全，全部；
onym	做词根时的意思：<br />name，名字<br />eg：<br />anonymous<br />无名的；假名的；匿名的；没有特色的；<br />anonymity<br />匿名；作者不详；匿名者；无名者；<br />pseudonym<br />假名，化名，（尤指）笔名；	***************<br />做单词时的意思：<br />n.<br />术语；
oper	做词根时的意思：<br />work,工作<br />eg：<br />operation<br />操作，经营；手术；[数]运算；作用；<br />cooperate<br />合作，配合，协助；  合群；互助；结合；<br />cooperation<br />合作； 协作；协助；配合；	***************<br />做单词时的意思：<br />abbr.<br />operating 操作的；operational 操作的；op
opt	做词根时的意思：<br />choose,选择<br />eg：<br />option<br />选择（的自由）；选项；选择权；选择能力；  得到或获准进行选择；调动球员；<br />optional<br />可选择的；随意的，任意的；非强制的；选修科目；<br />adopt<br />采用，采取，采纳；收养；正式接受，接受；批准；	***************<br />做单词时的意思：<br />vi.<br />选择，挑选；
optim	做词根时的意思：<br />best,最好<br />eg：<br />optimistic<br />乐观的，乐观主义的；<br />optimum<br />最适宜的；  最佳效果；最适宜条件；[生物学] 最适度；<br />optimal<br />最佳的，最优的；最理想的；	***************<br />做单词时的意思：<br />abbr.<br />optimization(al)(ly)；optimize(d)<br />13<br />optimization(al)(ly)；optimize(d)
ora	做词根时的意思：<br />mouth, 嘴，说<br />eg：<br />oracle<br />神示所；神谕；圣贤；哲人；<br />oration<br />（正式仪式中的）演说，演讲；<br />oratory<br />演讲术；（用长词或正式词语的）词藻华丽的言辞；	***************<br />做单词时的意思：<br />n.<br /><拉>口，孔；
orbit	做词根时的意思：<br />circle，圆圈<br />eg：<br />orbit<br />轨道；势力范围；眼眶；（人生的）旅程，生活过程；  在…轨道上运行，环绕轨道运行；  盘旋；绕轨道运行；  绕轨道而行；进入轨道；<br />exorbitant<br />过度的，极高的；<br />orbital<br />轨道的；眼窝的；	***************<br />做单词时的意思：<br />n.<br />轨道；势力范围；眼眶；（人生的）旅程，生活过程；<br />vt.& vi.<br />在…轨道上运行，环绕轨道运行；<br />vi.<br />盘旋；绕轨道运行；<br />vt.<br />绕轨道而行；进入轨道；
ordin	做词根时的意思：<br />order,命令，顺序<br />eg：<br />ordinance<br /><正>条例，法令；传统的风俗习惯；[宗]仪式，（尤指）圣餐式；<br />ordinary<br />普通的；平常的；一般的；平庸的；<br />extraordinary<br />非凡的；特别的；非常奇特的；	***************<br />做单词时的意思：
ori	做词根时的意思：<br />rise,begin,升起，开始<br />eg：<br />orient<br />标定方向；使…向东方；以…为参照；使熟悉或适应；  东方的；（太阳等）上升的，新生的；闪闪发光的；  转向东方；使调整或者成为一条直线；  东亚各国；珍珠光泽；好的珍珠；日出之处，东方；<br />oriental<br />东方的；东方人的；东方文化的；优质的；  东方人；东亚人；<br />orientation<br />方向，定位，取向，排列方向；任职培训；（外交等的）方针[态度]的	***************<br />做单词时的意思：<br />abbr.<br />orientation inventory 倾向性目录；
orn	做词根时的意思：<br />embellish,装饰<br />eg：<br />adorn<br />装饰，修饰；佩戴；使生色；<br />adornment<br />装饰，装饰品；<br />ornament<br />装饰；装饰物；[乐]装饰音；  装饰；美化；	***************<br />做单词时的意思：<br />abbr.<br />ornament 装饰（物）；ornamentation 装饰；
oss	做词根时的意思：<br />bone，骨头<br />eg：<br />osseous<br />骨的；多骨的；有骨的；<br />ossify<br />骨化，硬化，使僵化；<br />fossil<br />化石；僵化的事物；老顽固，食古不化的人；习语中保存的旧词；  化石的；陈腐的，守旧的；	***************<br />做单词时的意思：<br />abbr.<br />ourselves 我们自己；order short shipp<br />abbr.<br />ourselves 我们自己；order short shipp
oto	做词根时的意思：<br />ear，耳朵<br />eg：<br />otitis<br />耳炎；<br />otopathy<br />耳病；<br />otology<br />耳科学；	***************<br />做单词时的意思：<br />abbr.<br />(Latin prefix=ear) （拉丁语前缀）耳朵；one
out-	做词根时的意思：<br />超过，过度<br />eg：<br />outwit<br />以智取胜，以计击败；<br />outdo<br />胜过，优于；<br />outlive<br />比…长寿；度过…而健在；	***************<br />做单词时的意思：<br />adv.<br />出局；在外，在外部；完全，彻底；出版；<br />prep.<br />（表示来源）从；（从…里）出来；（表示不在原状态）脱离；离去；<br />vt.<br />使熄灭；揭露；驱逐；<br />adj.<br />外面的；出局的；下台的；外围的；<br />n.<br />不流行；出局；
over-	做词根时的意思：<br />过度，过分<br />eg：<br />overdose<br />过量用药；  用药过量；  给服过量的药；<br />overstudy<br />过度用功；  （使）用功过度；<br />overwork<br />工作过度或时间过长；把…做过头；对…使用过度：过于经常使用；装饰 过度工作；	***************<br />做单词时的意思：<br />prep.<br />（表示方向）越过；（部份或全部覆盖）在…上面；由于；（表示论及）<br />adv.<br />结束；再；（倒）下；从一边至另一边；<br />adj.<br />过去的；外面的；在上的；上级的；<br />n.<br />额外；剩余；剩余（或多余）的量；剩余物；<br />int.<br />[电信学]报文完，请回复！；<br />vt.<br />走过，跳过；[美国方言]从…恢复过来；
pact	做词根时的意思：<br />fastened，紧的<br />eg：<br />pact<br />条约，公约；公约；<br />compact<br />压紧，（使）坚实；把…弄紧密，把…弄结实；使（文体）简洁，简化； 紧凑的；简洁的，（文体等）紧凑的；小巧易携带的；（物质）致密的， 协议；条约；带镜小粉盒；小汽车；<br />impact<br />碰撞，冲击，撞击；影响；冲击力；  挤入，压紧；撞击；对…产生影响；  冲撞，冲击；产生影响；	***************<br />做单词时的意思：<br />n.<br />条约，公约；公约；
paleo	做词根时的意思：<br />古，旧<br />eg：<br />paleontology<br />古生物学；<br />paleozoology<br />古动物学；	***************<br />做单词时的意思：<br />abbr.<br />paleography 古文书，古文书学；
palp	做词根时的意思：<br />feel，感觉，摸<br />eg：<br />palpable<br />明白的，明显的；可感知的，摸得出的；<br />palpitate<br />（心脏）悸动；突突跳；急速地跳动；颤抖；<br />palpus<br />触须；须子；	***************<br />做单词时的意思：<br />n.<br />触须；触器；
pan	做词根时的意思：<br />广泛的<br />eg：<br />pandemic<br />（疾病）大流行的；普遍的，全世界的；  （全国或全球性）流行病，大流行病；<br />panorama<br />全景画；全景照片；一连串景象或事；概论；<br />panegyric<br />赞美； 称颂； 颂词；颂扬的演讲或文章；	***************<br />做单词时的意思：<br />n.<br />平底锅；盘状的器皿；淘盘子，金盘，秤盘；<br />vt.<br />淘金；在浅锅中烹调（食物）；[非正式用语]严厉的批评；<br />vi.<br />淘金；在淘洗中收获金子；
par	做词根时的意思：<br />equal,平等<br />eg：<br />parity<br />平价，价值对等；同等，平等；奇偶性；<br />disparage<br />轻视；贬低；批评；非难；<br />compare<br />比较，对照；  比拟，喻为；[语]构成；  相比，匹敌；比较，区别；比拟（常与to连用）；  比较；	***************<br />做单词时的意思：<br />n.<br />标准，常规；同等；票面价值；[体]标准杆数；<br />adj.<br />平价的；平均的，正常的；票面的；<br />vt.<br />标准杆数得分；
para	做词根时的意思：<br />半，类似，辅助<br />eg：<br />parapolitical<br />准政治性的；<br />parastatal<br />半国营的；  半国营集团；	***************<br />做单词时的意思：<br />n.<br /><口>帕拉胶；
parl	做词根时的意思：<br />speak，说话<br />eg：<br />parley<br />和谈，谈判；<br />parliament<br />议会，国会；<br />parlance<br />腔调，说法，用语；	***************<br />做单词时的意思：<br />abbr.<br />parallel 平行的，类似的，并联的；
part	做词根时的意思：<br />divide,部分，分开<br />eg：<br />partial<br />部分的；偏爱的；偏袒的；钟爱的；  [数学]偏微商；<br />impartial<br />不偏不倚的；公平的，公正的；无私的；持平；<br />particle<br />微粒，颗粒；[数，物]粒子，质点；极小量；小品词；	***************<br />做单词时的意思：<br />n.<br />部分；零件；参加；地区；<br />vt.<br />使分裂；拆移；使分开；<br />vi.<br />分开；分离；分岔；<br />adv.<br />不完全地，部分地；<br />adj.<br />不完全的，部分的；
pass	做词根时的意思：<br />通过<br />eg：<br />passage<br />（文章的）一段；经过；通路，通道；旅程，行程；<br />passenger<br />乘客，旅客；行人，过路人；碍手碍脚的人；<br />passport<br />护照，通行证；手段；	***************<br />做单词时的意思：<br />vt.& vi.<br />走过；通过；批准；度过；<br />vt.<br />传球；及格；发生；不要；<br />n.<br />通道；通行证；关口；越过；
pater	做词根时的意思：<br />父，祖<br />eg：<br />paternalism<br />家长式制度；  家长式的；<br />paten<br />圣餐碟，祭碟，金属制平碟；	***************<br />做单词时的意思：<br />n.<br />（英国学生用的俚语）父亲；
path	做词根时的意思：<br />feeling,suffering,illness,感情，痛苦，<br />eg：<br />pathos<br />悲怆，哀婉，凄楚，伤感；痛苦；同情；<br />pathetic<br />令人同情的，可怜的；又笨又可怜的，无价值的；荡气回肠；<br />antipathy<br />反感；引起反感的事物；憎恶的对象；<古>（在本性、倾向等方面的）	***************<br />做单词时的意思：<br />n.<br />小路，路；路线，路程；〈比喻〉（人生的）道路；（思想，行为，生活
patr	做词根时的意思：<br />父，祖<br />eg：<br />patriot<br />爱国者，爱国主义者；<br />patriotic<br />爱国的，有爱国心的；爱国主义的；<br />patriotism<br />爱国主义；爱国心，爱国精神；	***************<br />做单词时的意思：<br />abbr.<br />patriotic 爱国的；patron 货主；顾客；主顾；
ped	做词根时的意思：<br />foot, 脚<br />eg：<br />pedal<br />踏板；脚蹬子；垂足线；  踩自行车的踏板；骑自行车；  脚的；踏板的；<br />pedestrian<br />步行者；行人；  徒步的；平淡无奇的；一般的；<br />biped<br />两足动物；	***************<br />做单词时的意思：<br />n.<br />土壤自然结构体；
pel	做词根时的意思：<br />drive,push, 驱动，推<br />eg：<br />compel<br />强迫，迫使；强制发生，使不得不；<br />expel<br />驱逐；赶走；把…除名；排出（气体等）；<br />impel<br />推动、推进或敦促某人做某事；	***************<br />做单词时的意思：<br />abbr.<br />proportional elastic 弹性极限；图元；
pen	做词根时的意思：<br />近似，差不多<br />eg：<br />peninsula<br />半岛；[史]伊比利亚半岛，（第一次世界大战中指）加利波利半岛；（<br />penultimate<br />倒数第二的；倒数第二音节的；  倒数第二；倒数第二音节；	***************<br />做单词时的意思：<br />n.<br />笔，笔尖；笔法，文笔；作家；围栏；<br />vt.<br />写；把…关入栏中；关押，囚禁；
pend	做词根时的意思：<br />hang, 悬挂<br />eg：<br />pendant<br />（装在项链等上的）垂饰，坠儿；<br />pending<br />直到，在等待…期间；  未决的；未定的；待定的；即将发生的；<br />pendulum<br />摆，钟摆；摇摆不定的事态（或局面）；	***************<br />做单词时的意思：<br />vi.<br />悬而未决；
pens	做词根时的意思：<br />weight,expend, 称重量，称银子，引申为“花费”<br />eg：<br />expensive<br />昂贵的，花钱多的；豪华的；<br />pension<br />退休金，养老金；膳宿费；生活津贴；寄宿学校；  发给…养老金[退休金]；准予退休，强迫退休（并发给退休金）；<br />compensate<br />补偿，赔偿；报酬；抵消；  补偿，弥补；	***************<br />做单词时的意思：<br />n.<br />笔( pen的名词复数 )；钢笔；圆珠笔；写作；
penta	做词根时的意思：<br />五<br />eg：<br />pentoxide<br />五氧化物；<br />pentagram<br />五角星形；<br />pentagon<br />五边形，五角形；五角大楼（指美国国防部）；	***************<br />做单词时的意思：<br />abbr.<br />pentaerythritol 季戊四醇；
per-	做词根时的意思：<br />贯穿，自始至终<br />eg：<br />perspective<br />透镜，望远镜；观点，看法；远景，景色；洞察力；  （按照）透视画法的；透视的；<br />perennial<br />终年的，长久的；多年生的；不断生长的；四季不断的；  多年生植物；长期存在的；<br />perspire<br />出汗，流汗；  汗液可通过的；可随汗液排出的；排汗的；引起排汗的；	***************<br />做单词时的意思：<br />prep.<br />由；（表示根据）依照；（表示比率）（尤指数量，价格，时间）每；<br />adv.<br />每次；每个；照常；按惯例；<br />adj.<br />高的，过的，全的；
peri	做词根时的意思：<br />周围，靠近<br />eg：<br />perimeter<br /><数>周长；周围，边界；<br />periphery<br />边缘；圆周；外围；边缘地带；<br />perigon<br />周角，三百六十度角；	***************<br />做单词时的意思：<br />n.<br />妖精；美女；仙女；<br />pref.<br />周围；附近；环绕；
pet	做词根时的意思：<br />seek,追寻，寻求<br />eg：<br />petition<br />请愿书，；请愿，请求；上诉状；  祈求，请求；请愿；  （向法庭）申诉；<br />petitioner<br />请求人，请愿人；<英>离婚案原告；<br />appetite<br />欲望；胃口，食欲；嗜好，爱好；	***************<br />做单词时的意思：<br />n.<br />宠物；宠儿；受宠的人；生气；<br />adj.<br />宠爱的，溺爱的；表示亲昵的；<br />vt.<br />宠爱；爱抚，亲抚；<br />vi.<br /><非正>亲吻；爱抚；
phag	做词根时的意思：<br />eat,吃<br />eg：<br />anthropophagous<br />食人的；<br />phytophagous<br />（昆虫）食植（物）的，食叶类的；植食性；<br />zoophagous<br />食肉的；	***************<br />做单词时的意思：<br />abbr.<br />(Latin prefix=to eat) （拉丁语前缀）吃；<br />13<br />(Latin prefix=to eat) （拉丁语前缀）吃；
phan	做词根时的意思：<br />show，显示<br />eg：<br />phantom<br />幻影；幽灵；错觉；恐惧的事物；  幽灵似的；幻影的，虚幻的；虚构的；<br />sycophant<br />谄媚者，拍马屁者；<br />diaphanous<br />（织物等）（半）透明的；	***************<br />做单词时的意思：<br />n.<br />表象，显像；
phil	做词根时的意思：<br />love,爱<br />eg：<br />philology<br />语文学；<br />neophilia<br />喜欢新奇，对新事物的强烈兴趣；<br />philosophy<br />哲学；哲学体系，哲学思想；生活信条；哲理；	***************<br />做单词时的意思：<br />abbr.<br />philosophy 哲学；philological 语言学的；
phob	做词根时的意思：<br />dislike,厌恶<br />eg：<br />phobia<br />恐惧；厌恶；<br />acrophobia<br />恐高症；巨高恐怖；<br />xenophobia<br />对外国人的憎恶[恐惧]；	***************<br />做单词时的意思：
phon	做词根时的意思：<br />sound,声音<br />eg：<br />phonetics<br />语音（学）；发音学；语音学；<br />euphonious<br /><正>悦耳的；<br />cacophony<br />刺耳的声音，不和谐的声音；	***************<br />做单词时的意思：<br />n.<br />音响的强度单位；
phor	做词根时的意思：<br />bring，带来<br />eg：<br />euphoria<br />精神欢快；幸福感；欣快；<br />aphorism<br />格言，警句；<br />dysphoria<br />病理性心境恶劣，烦躁不安；躁动；烦满；躁扰；	***************<br />做单词时的意思：<br />abbr.<br />Phoronida 帚虫动物门；
phyt	做词根时的意思：<br />plant，植物<br />eg：<br />xerophyte<br />旱生植物；<br />phytogeography<br />植物地理学；	***************<br />做单词时的意思：
pict	做词根时的意思：<br />paint,描画<br />eg：<br />picture<br />照片，画像；图画，图片；影片；情景；  构想，想象；描绘，画；描述；<br />picturesque<br />美丽的；别致的；生动的；奇特的，独创的；<br />depict<br />描绘，描画；描述；	***************<br />做单词时的意思：<br />abbr.<br />pictorial 图示的；画报；picture 画；图片；
pisc	做词根时的意思：<br />fish，鱼<br />eg：<br />piscine<br />鱼的；<br />piscivorous<br />食鱼的；<br />piscary<br />捕鱼权，捕鱼场；	***************<br />做单词时的意思：<br />abbr.<br />Philippine International Shippin
plac	做词根时的意思：<br />to please,取悦，使满意，使平静<br />eg：<br />placate<br />安抚，抚慰，使平静；使和解，平息；<br />placid<br />平和的，宁静的；温和的；满意的，满足的；平缓；<br />placebo<br />安慰剂；宽心话；为死者所诵的晚祷词；（试验药物用的）无效对照剂；	***************<br />做单词时的意思：<br />abbr.<br />placebo capsule 安慰剂胶囊；
plaint	做词根时的意思：<br />complain，抱怨<br />eg：<br />plaintive<br />悲哀的，哀怨的；哭诉的；可怜的；忧郁的；<br />plaintiff<br /><律>原告；<br />complaint<br />抱怨，控诉；委屈，怨言；平平的来由；痛苦根源；	***************<br />做单词时的意思：<br />n.<br /><诗>悲叹；感叹；抱怨；诉苦；
plat	做词根时的意思：<br />flat,平坦<br />eg：<br />plate<br />盘子，盆子；金属板；均匀厚度的片状硬物体；[摄]底片，感光版；  镀，在…上覆盖金属板；覆盖；电镀；[印]给…制铅板；<br />plateau<br />高原；平稳时期，稳定水平；停滞期；  进入停滞期；达到平稳状态；<br />platform<br />台；站台；平台；纲领；  把…放在台上；为…设（平）台；（在台上）演讲；	***************<br />做单词时的意思：<br />n.<br />小块地，地图；<br />vt.<br />制…的地图，绘…地区图；<br />abbr.<br />Projectile Infantry Anti-Tank 步兵
plaud	做词根时的意思：<br />clap hands，鼓掌<br />eg：<br />applaud<br />鼓掌欢迎，欢呼；称赞，赞许；赞成，同意；  夸赞，鼓掌；<br />applause<br />热烈鼓掌；喝彩；掌声；<br />plausible<br />貌似真实的；貌似有理的；花言巧语的；有眉有眼；	***************<br />做单词时的意思：
ple	做词根时的意思：<br />full,fill,满，填满<br />eg：<br />complement<br />补充；补足语；补充物；补集（数）；  补足，补充；补助；<br />implement<br />实施，执行；使生效，实现；落实（政策）；把…填满；  工具，器械；家具；手段；[法]履行（契约等）；<br />supplement<br />增补，补充；  增补，补充；补充物；增刊，副刊；	***************<br />做单词时的意思：<br />[医][=panlobular emphysema]全肺泡性气肿
plex	做词根时的意思：<br />fold,重叠<br />eg：<br />complex<br />复杂的；难懂的；复合的；  建筑群；相关联的一组事物；情结；不正常的忧虑；<br />complexity<br />复杂性，错综复杂的状态；复杂的事物；复合物；<br />duplex<br />有两部分的；  连栋式的两栋住宅；联式房屋；占两层楼的公寓套房；复式住宅；	***************<br />做单词时的意思：<br />n.<br />丛；
pli	做词根时的意思：<br />full,fill,满，填满<br />eg：<br />accomplish<br />完成；达到（目的）；走完（路程、距离等）；使完美；<br />accomplished<br />才华高的；技艺高超的；熟练的；<br />compliment<br />恭维；敬意；道贺，贺词；致意；  向…道贺；称赞；向…致意；	***************<br />做单词时的意思：<br />abbr.<br />pounds per linear inch磅/（线）英寸；
plic	做词根时的意思：<br />fold,重叠，折叠<br />eg：<br />complicate<br />使复杂化；使错综，使混乱；使卷入；变复杂；  复杂的；麻烦的；（昆虫的翅）纵折的；<br />complication<br />[医]并发症；错杂，纠纷；混乱，精神错乱；<br />explicate<br /><正>解释，说明（文章或计划等）；引申，阐述 （学说、理论、原理	***************<br />做单词时的意思：<br />[计]= Procedural Language for Int
plor	做词根时的意思：<br />cry，weep,喊，哭<br />eg：<br />deplore<br />悲悼，哀叹；谴责，强烈反对；<br />explore<br />勘查， 探测， 勘探；[医]探查（伤处等），探索，研究；  探索， 探究， 仔细查看；<br />exploration<br />探测，勘探，探险；搜索，研究；[医]探查术；	***************<br />做单词时的意思：
ploy	做词根时的意思：<br />use，invlve，用，参与<br />eg：<br />employ<br />雇用；使用，利用；  受雇；服务；工作；<br />employment<br />雇用；使用；职业；有益的活动；<br />deploy<br />（尤指军事行动）使展开；施展；有效地利用；	***************<br />做单词时的意思：<br />n.<br />策略，手法；工作；<br />v.<br />横队变纵队；
pold	做词根时的意思：<br />big noise，大声音<br />eg：<br />plod<br />沉重地走；  沉重缓慢地行走；孜孜不倦，勤苦地工作；  沉重缓慢的前进；沉重的踏步声；<br />explode<br />爆[突]发，发怒；激增，迅速扩大；  （使）爆炸；突然（发出巨响，活跃起来，迸发感情）；推翻；驳倒；<br />explosion<br />爆炸，炸裂；爆发；扩张，激增；（感情，尤指愤怒的）突然爆发；	***************<br />做单词时的意思：<br />abbr.<br />polished 擦亮的，磨光的，有光泽的；
poli	做词根时的意思：<br />state,city,国家，城市<br />eg：<br />police<br />警察部门；警方；警察；治安；  （警察、军队等）巡查；维护治安；（委员会等）监督；管制；  警察的；有关警察的；<br />policy<br />政策；策略；保险单；策略性；<br />politics<br />政治；政治事务；政治观点；权术；	***************<br />做单词时的意思：<br />[医]（单polus）极；<br />0<br />[医]（单polus）极；
poly	做词根时的意思：<br />多<br />eg：<br />polyandry<br />一妻多夫（制）；一妻多夫制；多雄性；一雌多雄；<br />polyglot<br />（人）通晓、使用多种语言的，（书等）用多种语言写的；  通晓多种语言的人；<br />polyfunctional<br />多官能的，多机能的，多重性的；	***************<br />做单词时的意思：<br />n.<br />工艺学校；聚酯纤维；<br />abbr.<br />聚乙烯（全称polyethylene）；
pon	做词根时的意思：<br />put,放置<br />eg：<br />component<br />成分；零件；[数]要素；组分；  组成的；合成的；构成的；成分的；<br />opponent<br />对手；反对者；敌手；  对立的；敌对的；<br />proponent<br />支持者，拥护者；提倡者；提出认证遗嘱者；	***************<br />做单词时的意思：<br />abbr.<br />pontoon 浮桥，浮筒；<br />13<br />pontoon 浮桥，浮筒；
popul	做词根时的意思：<br />人民<br />eg：<br />population<br />人口；全体居民；特定[生物]种群；[物]布居；<br />populous<br />人口众多的；人口稠密的；<br />populate<br />居住于；生活于；移民于；落户于；	***************<br />做单词时的意思：
port	做词根时的意思：<br />carry,拿，运,港口<br />eg：<br />portable<br />手提的；轻便的；  手提式打字机；<br />porter<br />门童；搬运工人；（医院里护送病人的）护工；（尤指卧铺车厢的）列车<br />portfolio<br />公文包；代表作品集；证券投资组合；部长[大臣]的职位；	***************<br />做单词时的意思：<br />n.<br />港口；（事情的）意义；（计算机与其他设备的）接口；（船、飞机等的<br />vt.<br />举枪；持枪；左转舵；<br />vi.<br />转向左舷；<br />adj.<br />左舷的，左侧的；<br />vt.& vi.<br />转舵（向左），把（舵）转向左边；<br />adv.<br />向左舷，向左；
pos	做词根时的意思：<br />put, 放<br />eg：<br />pose<br />使摆姿势；以…身份出现；招摇；炫耀；  提出；造成（威胁、问题等）；引起；产生；  姿势；姿态；装腔作势；伪装；<br />compose<br />组成，构成；调解；[印刷]排（字）；使安定；  创作（乐曲、诗歌等）；为…谱曲；  构图，构成；<br />composure<br />镇静，沉着；头脑镇定或沉着的状态；	***************<br />做单词时的意思：<br /><美口>便壶，夜壶(po的复数)；
post-	做词根时的意思：<br />在后面<br />eg：<br />postwar<br />战后的；<br />postpone<br />使延期，延缓；把…放在次要地位；把…放在后面；  延缓；延缓发作；<br />postgraduate<br />研究生的；  研究生；	***************<br />做单词时的意思：<br />n.<br />邮件；邮政；柱，桩，杆；岗位；<br />vt.<br />张贴；宣布；设岗；邮寄；<br />vi.<br />快速行进；<br />adj.<br />有关赛跑（或赛马，赛狗）起点标志的；<br />adv.<br />〈外〉在后；用急件[驿马]；赶紧地，火速地；
pound	做词根时的意思：<br />put,放置<br />eg：<br />compound<br />场地；复合物；（筑有围墙的）院子；复合词；  调和；使混合；使严重；调停；  复合；[语法学]（句子）复合的；合成的；多功能的；  妥协；和解；达成协议；（通过妥协）解决债务、主权等；<br />expound<br />解释，详细讲解；<br />propound<br />提出（问题、计划等）供考虑[讨论]，提议；	***************<br />做单词时的意思：<br />n.<br />英镑；磅；兽栏；重击声；<br />vt.& vi.<br />连续重击；咚咚地走；<br />vi.<br />（持续地）苦干；（驾舟时）拍打（水面）；（心脏）狂跳；脚步沉重地<br />vt.<br />连续重击；捣碎，碾碎；强迫吸收；猛烈袭击；
prais	做词根时的意思：<br />value, 价值<br />eg：<br />appraise<br />估价；估计；估量；评价，鉴定；<br />appraisal<br />评价，估量；鉴定，估价（尤指估价财产，以便征税）；	***************<br />做单词时的意思：<br />abbr.<br />passive-ranging interferometer s
pre-	做词根时的意思：<br />之前，预先<br />eg：<br />preposition<br />介词；前置词；<br />preamble<br />序；绪言；（法令、文件等的）序文；前言；<br />precaution<br />预防，防备，警惕；预防措施；避孕措施；  使提防；预先警告；	***************<br />做单词时的意思：<br />abbr.<br />prefix 前缀（计算机字符）；(Latin prefix=b
preci	做词根时的意思：<br />value, 价值<br />eg：<br />precious<br />宝贵的，珍贵的；贵重的；矫揉造作的；可爱的，宝贝的；  <口>很，非常；  珍爱的人；可爱的人；<br />appreciate<br />感激；欣赏；领会；鉴别；  （使）增值，涨价；<br />appreciable<br />可预见的；可估计的；可察觉的；相当可观的；	***************<br />做单词时的意思：<br />[地名] [意大利] 普雷奇；
prehend	做词根时的意思：<br />catch,抓住<br />eg：<br />apprehend<br />理解；逮捕，拘押；忧虑；  理解；担心；<br />comprehend<br />理解，领会；包含；<br />comprehensive<br />广泛的；综合的；有理解力的，悟性好的；[保险业]总体担保的；  [常用复数]专业综合考试；综合学校；综合性中学；	***************<br />做单词时的意思：
press	做词根时的意思：<br />挤压<br />eg：<br />pressing<br />紧迫的，紧急的；迫切的，急迫的；恳切的；  压，压制；模压制品；力主；唱片；  压，压迫(press的现在分词)；<br />pressure<br />压（力）；压力；气压（或血压）（的缩略形式）；压（迫）感；  施加压力；迫使；使（机舱等）增压；<br />compress<br />压紧；压缩；精简；  止血敷布；打包机；	***************<br />做单词时的意思：<br />vt.<br />压，按；逼迫；紧抱；<br />vi.<br />压；逼迫；重压；<br />n.<br />强迫征兵；新闻报道，出版物；压榨；印刷机（厂）；
prim	做词根时的意思：<br />first,chief, 第一，主要的<br />eg：<br />primary<br />首要的，主要的；最早的，原始的；[地质学]原生的；基本的；  第一位；最好者；要素；候选人提拔会；<br />primitive<br />原始的；发展水平低的；落后的；[生物学]原生的；  原始人；早期的艺术家（作品）；单纯的人：不世故的人；自学的艺术家<br />prime<br />最好的；首要的；最初的；基本的；  精华；初期；全盛时期；青年；  使准备好；填装；事先指导；  极好地；  （为枪炮）装火药；涂底漆；修剪树枝；注水入泵引起；	***************<br />做单词时的意思：<br />adj.<br />循规蹈矩的；整洁的；（人）一本正经；<br />adv.<br />循规蹈矩地，整洁地；<br />v.<br />（使）一本正经；使整洁；
pris	做词根时的意思：<br />take, 拿住，抓住<br />eg：<br />surprise<br />使惊奇；突袭；意外发现；  惊喜，惊奇；意外的事；<br />apprise<br />告知，通知；评价；<br />comprise<br />包含，包括；由…组成；由…构成；	***************<br />做单词时的意思：<br />abbr.<br />prison 监狱；prisoner 囚犯，俘虏；
priv	做词根时的意思：<br />single,alone, 单个<br />eg：<br />private<br />私有的，私人的；秘密的；内心的；平民的，无官职的，士兵的；  列兵，士兵，[陆]二等兵；〈古〉私人，个人；阴部，生殖器；<br />privacy<br />隐私，秘密；隐居；私事；不受公众干扰的状态；<br />privation<br />（生活必需品的）匮乏，贫困；	***************<br />做单词时的意思：<br />abbr.<br />privacy 秘密；privily 秘密地；privation<br />13<br />privacy 秘密；privily 秘密地；privation
pro-	做词根时的意思：<br />向前，在前<br />eg：<br />progress<br />进步；前进；[生物学]进化；（向更高方向）增长；  （使）进步，（使）进行；发展；促进；  发展；（向更高方向）增进；<br />project<br />放映；计划；发射；展现，使突出；  伸出，突出；  项目，工程；计划，规划；（学生的）课题；<br />prologue<br />序言，开场白；  作序言，作开场白；	***************<br />做单词时的意思：<br />n.<br />赞成者；赞成的意见；赞成票，投赞成票者；<br />adv.<br />赞成地；肯定地；
prob	做词根时的意思：<br />test, 测试，证明<br />eg：<br />approbation<br />认可；许可；批准；赞许；<br />probable<br />可能的；大概的；  很可能的事；可能入选者；<br />probability<br />可能性；几率，概率；或然性；	***************<br />做单词时的意思：<br />abbr.<br />problem 问题；probability 概率；proble<br />13<br />problem 问题；probability 概率；proble
proper	做词根时的意思：<br />one's own, 拥有，引申为“恰当的”<br />eg：<br />property<br />特性，属性；财产，地产；[戏]道具；所有权；<br />proprietor<br />所有人，业主；地主；<br />appropriate<br />适当的；恰当的；合适的；  盗用；侵吞；拨（专款等） ；	***************<br />做单词时的意思：<br />adj.<br />适当的，相当的，正当的，应该的，正式的，正常的；固有的，特有的，<br />adv.<br />〈方〉适当地，好好地，非常，很，完完全全地，彻底地；<br />n.<br />[宗教][常用P-]特定节日等用的仪式，弥撒（祈祷、礼仪等）书的
prov	做词根时的意思：<br />test, 测试，证明<br />eg：<br />approve<br />赞成，同意；  批准；认可；核准；为…提供证据；  赞同；称许；称赞；满意、喜欢(of)；<br />approval<br />同意；批准；赞成；<br />disprove<br />反驳；证明…是虚假的；	***************<br />做单词时的意思：<br />abbr.<br />provide 提供；province 省；provincia
pseudo	做词根时的意思：<br />假，伪<br />eg：<br />pseudonym<br />假名，化名，（尤指）笔名；<br />pseudology<br />说谎，捏造，说谎术；<br />pseudograph<br />伪作，伪书；	***************<br />做单词时的意思：<br />adj.<br />假的，虚伪的；<br />n.<br />[口]假冒的人，伪君子；
publ	做词根时的意思：<br />people,人民<br />eg：<br />public<br />公众的，公共的；公开的；政府的；人人知道的，知名的；  大众；社会；公共场所；（文学家等的）爱读者；<br />publish<br />出版，发行；发表，宣布（结婚等）；公布，颁布；出版…的著作；<br />publication<br />出版；出版物；公布；发表；	***************<br />做单词时的意思：<br />abbr.<br />publish 出版；publishing 出版；publish
pugn	做词根时的意思：<br />fight,打斗<br />eg：<br />impugn<br />非难，指谪；对…有怀疑；<br />repugnant<br />令人厌恶的；矛盾的；<br />repugnance<br />厌恶；憎恶；抵触；不一致；	***************<br />做单词时的意思：
puls	做词根时的意思：<br />drive,push, 驱动，推<br />eg：<br />compulsion<br />强迫；强制；冲动；打动人的力量；<br />compulsory<br />必须做的，强制性的；义务的；必修的；<br />expulsion<br />驱逐；开除；排出；喷出；	***************<br />做单词时的意思：<br />[人名] 普尔斯；
pur	做词根时的意思：<br />pure, 纯洁<br />eg：<br />purity<br />[化学]纯度；纯洁，纯净；清洁，清白，清廉；（语言）纯正；<br />purify<br />使纯净，净化；精炼；使（语言）纯正；给…赎罪，使纯洁；<br />purge<br />清除，（使）净化；（使）通便；肃清；  净化；<医>泻药；整肃；	***************<br />做单词时的意思：<br />v.<br />咕噜咕噜叫，发出喉音；
put	做词根时的意思：<br />think, 认为，思考<br />eg：<br />compute<br />计算，估算；推断；用计算机计算；  计算；<br />computer<br />（电子）计算机，电脑；<br />dispute<br />辩论，争论；  就…进行争论，辩论；对…的真实或有效进行争论，怀疑；争夺，竞争； 辩论；争端；（劳资）纠纷；罢工；  激烈争辩；争执；争吵；吵架；	***************<br />做单词时的意思：<br />vt.<br />放；表达；给予（重视、信任、价值等）；使处于（某种状态）；<br />vt.& vi.<br />使感觉到；使受到…的影响；<br />vi.<br />说；猛推；将…送往；使与…连接；<br />n.<br />[方]笨蛋，怪人；对策；<br />adj.<br />固定的；不动的；
qqqq	做词根时的意思：<br />shiyi1<br />eg：	***************<br />做单词时的意思：
quadr	做词根时的意思：<br />四<br />eg：<br />quadrangle<br />四边形；（尤指大学的学院等的）四方院子；<br />quadrilateral<br />四边（形）的；  四边形；<br />quadricycle<br />四轮车；  四轮的；	***************<br />做单词时的意思：
quit	做词根时的意思：<br />free, 自由<br />eg：<br />quit<br />离开；放弃，抛弃；停止，中断；偿清；  停止；放弃斗争；辞职；  自由的；摆脱了责任或义务的；<br />acquit<br />宣判无罪；除去责任或义务；表现，履行；付清，还清；<br />acquittal<br />宣告无罪；（义务、职责等的）履行；尽职；<古>（债务等的）清偿；	***************<br />做单词时的意思：<br />vt.<br />离开；放弃，抛弃；停止，中断；偿清；<br />vi.<br />停止；放弃斗争；辞职；<br />adj.<br />自由的；摆脱了责任或义务的；
radic	做词根时的意思：<br />root,根<br />eg：<br />eradicate<br />摧毁；完全根除；  根除者；褪色灵；<br />radix<br />根，基数；<br />eradicable<br />可根除的；	***************<br />做单词时的意思：<br />abbr.<br />radicular 根的；radical 基本的；radicle
range	做词根时的意思：<br />rank,排列，顺序<br />eg：<br />range<br />范围；射程；类别；（山脉，房屋等的）排列；  搜索；变化；延伸；漫游；  排列；（按一定位置或顺序）排序；把…分类；徘徊；  牧场的，放牧区的；<br />arrange<br />把…（系统地）分类；整理；改编（剧本等）；达成…的协议；  （就某事与某人）达成协议，（与某人）商定（某事）(with a<br />arrangement<br />安排；排列；约定；改编；	***************<br />做单词时的意思：<br />n.<br />范围；射程；类别；（山脉，房屋等的）排列；<br />vi.<br />搜索；变化；延伸；漫游；<br />vt.<br />排列；（按一定位置或顺序）排序；把…分类；徘徊；<br />adj.<br />牧场的，放牧区的；
rap	做词根时的意思：<br />snatch,捕，夺<br />eg：<br />rape<br />掠夺，强夺；强奸；  掠夺，强夺；[法]强奸；[植]油菜；葡萄渣；<br />rapacious<br />贪婪的；（尤指）贪财的；抢劫的；掠夺的；<br />rapt<br />全神贯注的，入迷的；	***************<br />做单词时的意思：<br />vt.& vi.<br />突然说出；（公开地）严厉批评；突然大声说出；连续敲叩；<br />n.<br />（轻快的）敲击（声）；说唱音乐；说唱歌；速度快的谈话；
rav	做词根时的意思：<br />snatch,捕，夺<br />eg：<br />ravish<br />使欣喜若狂，使着迷，使心醉；<br />ravage<br />毁坏；劫掠；  破坏；蹂躏；<br />raven<br />掠夺，劫掠；大乌鸦，渡鸦；  （指头发）乌亮的；  掠夺；狼吞虎咽地吃；	***************<br />做单词时的意思：<br />[医][=right a-v valve]右房室瓣；
re-	做词根时的意思：<br />再，重新，重复<br />eg：<br />review<br />复习；回顾；（报刊的）评论；[法]复审；  检验；复查；复习；评论；  复习功课；写评论；<br />resplendent<br />华丽灿烂的，辉煌的；靡丽；光芒万丈；鲜艳夺目；<br />reappear<br />再（出）现；再发生；	***************<br />做单词时的意思：<br />prep.<br />关于；<br />n.<br />[化]元素铼（rhenium）的符号，铼；
rect	做词根时的意思：<br />stright, right, 正，直<br />eg：<br />correct<br />正确的；合适的；符合公认准则的；得体的；  改正；批改；指出错误；<br />rectify<br />改正，校正；[化]精馏；[电]整流；<br />rectitude<br />操行端正；笔直；	***************<br />做单词时的意思：<br />abbr.<br />rectifier 整流器；rectification 纠正；(
retro	做词根时的意思：<br />向后，倒退<br />eg：<br />retrospect<br />回顾，回想；  回顾；追溯；<br />retrovert<br />向后弯曲，使后屈；<br />retroject<br />向后抛，掷回；	***************<br />做单词时的意思：<br />n.<br />制动火箭，减速火箭；（服装式样等）重新流行；复旧，怀旧；<br />adj.<br />复古的；怀旧的；
rid	做词根时的意思：<br />laugh,笑<br />eg：<br />ridiculous<br />可笑的，荒谬的；荒唐的，愚蠢的；胡枝扯叶；<br />ridicule<br />嘲笑；奚落；嘲弄；戏弄；  嘲笑，嘲弄，奚落；使…受嘲笑；取笑；<br />deride<br />嘲笑，愚弄；嘲弄；	***************<br />做单词时的意思：<br />vt.<br />使摆脱，解除，免除；
ris	做词根时的意思：<br />laugh,笑<br />eg：<br />risibility<br />爱笑，幽默感；<br />risible<br />可笑的，滑稽的；<br />derisive<br />嘲笑的，嘲弄的；  嘲笑地，嘲弄地；  嘲笑，嘲弄；	***************<br />做单词时的意思：<br />[医][=radioimmunosorbent]放射免疫吸附剂；
rod	做词根时的意思：<br />bite, 咬<br />eg：<br />corrode<br />使腐蚀，侵蚀；<br />corrosive<br />腐蚀性的；侵蚀性的；（对社会、个人情感等）有害的；（语言）激烈的 腐蚀性物品；<br />corrosion<br />腐蚀，侵蚀，锈蚀；受腐蚀的部位；衰败；	***************<br />做单词时的意思：<br />n.<br />杆，拉杆；惩罚，体罚；（责打人用的）棍棒；手枪；
rog	做词根时的意思：<br />ask, 要求,问<br />eg：<br />arrogate<br />冒称，妄取；没来由地把…归属（于）；<br />arrogant<br />傲慢的，自大的；带有傲慢，出自傲慢；骄慢；骄；<br />abrogate<br />废除（法律等）；取消；去掉；抛开；  取消，废除；	***************<br />做单词时的意思：<br />abbr.<br />reactive organic compound 活性有机化合
rot	做词根时的意思：<br />wheel, 轮子，转<br />eg：<br />rotate<br />（使某物）旋转；使转动；使轮流，轮换；交替；  [植]辐状的；有辐射部分的；<br />rotund<br />圆的；矮而胖的；洪亮的；夸张的；<br />rotundity<br />球状，圆形；	***************<br />做单词时的意思：<br />n.<br />腐烂，腐朽；<br />vt.& vi.<br />（使）腐烂，（使）腐朽；
rud	做词根时的意思：<br />原始，粗野<br />eg：<br />rude<br />粗鲁的；简陋的；狂暴的；近乎下流的；<br />erudite<br />博学的，有学问的；笃行不倦；渊深；渊识博学；<br />erudition<br />博学，学识；博雅；	***************<br />做单词时的意思：<br />[医]粗糙的，未开化的，粗暴的；<br />0<br />[医]粗糙的，未开化的，粗暴的；
rupt	做词根时的意思：<br />break, 断裂<br />eg：<br />rupture<br />断裂，破裂；友好关系的决裂；[医]疝气；  使破裂；断绝（关系等）；发生疝；使不和；  破裂；发疝气；<br />abrupt<br />突然的，意外的；无理的，唐突的；不连贯的；陡峭的；<br />bankrupt<br />破产的，倒闭的；完全缺乏的；（名誉）扫地的，（智力等）完全丧失的 破产者；无力偿还债务者；丧失（名誉，智力等）的人；  使破产，使枯竭，使极端贫困；	***************<br />做单词时的意思：<br />[医][=rupture]破裂，疝；<br />0<br />[医][=rupture]破裂，疝；
sal	做词根时的意思：<br />salt,盐<br />eg：<br />saline<br />含盐的，咸的；  盐湖，盐泉；盐溶液；<br />salinity<br />盐分，盐度；盐浓度；盐份；<br />salary<br />薪水，薪金，薪俸；  给…加薪；给…薪水；发…薪水；付…薪水；	***************<br />做单词时的意思：<br />abbr.<br />Semi-Actie Laster 半主动激光器；<br />n.<br />婆罗双树，盐；
san	做词根时的意思：<br />healthy,健康的<br />eg：<br />sane<br />心智健全的；神志正常的；明智的；稳健的；<br />sanity<br />神志正常；心智健康；头脑清楚；通情达理；<br />insane<br />疯狂的；精神病的；非常愚蠢的；	***************<br />做单词时的意思：<br />abbr.<br />sandwich 三明治；sanatorium 疗养院；sani
sanguin	做词根时的意思：<br />blood,血<br />eg：<br />sanguine<br />乐观的，充满希望的；面色红润的；血红色的；  血红色；自信，乐观；<br />exsanguine<br />无血的，失血的，贫血症的；<br />consanguineous<br />血亲的，血缘的，密切的；	***************<br />做单词时的意思：
sati	做词根时的意思：<br />enough,full of food,足够，饱足<br />eg：<br />sate<br /><正>使充分满足于（尤指坏事），使餍足，使厌腻；<br />satisfy<br />使满意，满足；  使确信；符合，达到（要求、规定、标准等）；消除；履行；  使满足或足够；使满意；<br />satisfaction<br />满足，满意，舒服；妥善处理；（债务的）清偿；（伤害的）赔偿；	***************<br />做单词时的意思：<br />n.<br />妻子的殉夫；
scend	做词根时的意思：<br />climb,爬，攀<br />eg：<br />ascend<br />攀登；继承；占领；  上升；爬坡；追溯；<br />descend<br />下来，下降 ；下斜；降临；突然造访；<br />condescend<br />屈尊，俯就；故意表示和蔼可亲；	***************<br />做单词时的意思：<br />n.<br />波浪的推动力，船的纵摇；<br />v.<br />随波浪载沉；
sci	做词根时的意思：<br />know, 知道<br />eg：<br />science<br />科学；技术，知识；学科；理科；<br />scientific<br />科学的；有系统的；应用科学的；精通学理的，有学问的；<br />conscience<br />良心；道德心；	***************<br />做单词时的意思：<br />abbr.<br />science 科学；scientific 科学的；ship-c
scrib	做词根时的意思：<br />write,写<br />eg：<br />scribble<br />潦草地书写；乱写，胡写；滥写（文学作品等）；[印，纺]粗梳；  潦草书写；乱写；拙劣文字；粗制滥造的文章；  乱写，乱涂；<br />ascribe<br />把…归于，认为…是由于；认为…具有；<br />circumscribe<br />在…周围划线；划定…范围；限制；限定；	***************<br />做单词时的意思：
script	做词根时的意思：<br />write,写<br />eg：<br />script<br />脚本，手迹；书写体铅字；剧本、广播稿或者电影剧本；  为电影（或戏剧等）写剧本；编造；<br />scripture<br />经文，圣典；文稿；<br />inscription<br />（作者）题词；献词；碑文；证劵持有人的登记；	***************<br />做单词时的意思：<br />n.<br />脚本，手迹；书写体铅字；剧本、广播稿或者电影剧本；<br />vt.<br />为电影（或戏剧等）写剧本；编造；
se	做词根时的意思：<br />分开，离开，区别开<br />eg：<br />secede<br />从…中脱离；  脱离；退出；<br />seclude<br />使隔开，使隔绝，使隐退；<br />secrete<br />[生]分泌；隐匿，隐藏；私下侵吞；	***************<br />做单词时的意思：<br />abbr.<br />Sweden 瑞典；standard error （平均）标准误<br />n.<br />[化]元素硒(selenium)的符号，硒；
sect	做词根时的意思：<br />cut,divide,切， 割<br />eg：<br />section<br />部分；节；部件；部门；  切开；切断；做（动物或植物组织）切片；把（精神病患者）正式送入精 把…切成片（或段）；作…的切片；把…作成截面；制作…的剖面图；<br />dissect<br />解剖；仔细分析；  进行解剖，进行详细分析；<br />dissection<br />解剖，切开，剥离；剖割；切割；切段；	***************<br />做单词时的意思：<br />n.<br />宗派，教派；学派，党派；
secut	做词根时的意思：<br />follow,跟随<br />eg：<br />persecute<br />（尤指宗教或政治信仰的）迫害；烦扰，困扰；强求，死缠着要；<br />consecutive<br />连续的，连贯的；[语]表示结果的；<br />prosecute<br />控告；起诉；继续从事；担任控方律师；	***************<br />做单词时的意思：
seg	做词根时的意思：<br />cut,divide,切， 割<br />eg：<br />segment<br />部分，段落；环节；[计算机]（字符等的）分段；[动物学]节片；  分割，划分；[生]使分裂；<br />segmentation<br />分割；切分；分段；分节；	***************<br />做单词时的意思：<br />n.<br /><美俚>种族隔离主义者，凹陷，阉割的动物；
sembl	做词根时的意思：<br />alike,same,相类似，一样<br />eg：<br />semblance<br />外表，外观；类似；假装；副本，拷贝；<br />assemble<br />集合，收集；  装配，组合；<br />dissemble<br />假装，掩饰（感情、意图等）；	***************<br />做单词时的意思：
semi	做词根时的意思：<br />半<br />eg：<br />semiconductor<br /><物>半导体；<br />semiautomatic<br />半自动的；<br />semicircle<br />半圆形，半圆形的周长，半圆形的东西；	***************<br />做单词时的意思：<br />n.<br />半独立式住宅；半挂车；
sen	做词根时的意思：<br />old,老<br />eg：<br />senior<br />（级别、地位等）较高的；资深的；年长的；<美>最高年级的；  上级；<美>毕业班学生；较年长者；地位较高的，资历较深的；<br />senile<br />衰老的，老年的；高龄的，高龄所致的；[地]老年期的；龙钟；<br />senator<br />参议员；	***************<br />做单词时的意思：<br />n.<br />钱（日本铜币，等于1/100日元）；
sens	做词根时的意思：<br />feel, 感觉<br />eg：<br />sense<br />感觉，官能；意识，观念；理性；识别力；  感到；理解，领会；检测出；<br />sensible<br />明智的；合乎情理的；通情达理的；意识到的，能感觉到的；  可感觉到的东西；敏感的人；<br />sensibility<br />情感；敏感性，灵敏度；感觉，感性；感光性，感光度；	***************<br />做单词时的意思：<br />[医][=sensitivities(test)]敏感性试验；
sent	做词根时的意思：<br />feel, 感觉<br />eg：<br />sentiment<br />感情，情绪；情操；意见，观点；感伤；<br />sentimental<br />伤感的；多愁善感的；感情用事的；寓有情感的；<br />assent<br />赞成：赞成，如某建议；赞同；  同意，赞同：；	***************<br />做单词时的意思：<br />v.<br />送( send的过去式和过去分词 )；使作出（某种反应）；派遣；
sequ	做词根时的意思：<br />follow,跟随<br />eg：<br />sequence<br />[数]数列，序列；顺序；连续；片断插曲；  使按顺序排列，安排顺序；[生化]确定…的顺序，确定…的化学结构序<br />sequential<br />按次序的，相继的，构成连续镜头的；时序；序贯；<br />consequence<br />结果，成果；[逻]结论；重要性；推论；	***************<br />做单词时的意思：
sert	做词根时的意思：<br />join, insert,加入，插入<br />eg：<br />assert<br />声称，断言；维护，坚持；坚持自己的主张；生效；<br />assertive<br />观点明确的；坚决主张的；<br />desert<br />沙漠；荒地；应得的赏罚；功劳，美德；  沙漠的；荒芜的，不毛的；无人的；  丢开，抛弃；擅离职守；逃亡，逃走；开小差；	***************<br />做单词时的意思：<br />abbr.<br />Society of Electronic and Radio
serv	做词根时的意思：<br />serve,keep,服务，保持<br />eg：<br />service<br />服务，服侍；服务业；维修服务；服役；  检修，维修；向…提供服务；保养；满足需要；  服务性的；耐用的；服现役的；<br />serviceable<br />有用的，可供使用的；耐用的；<br />servile<br />过分屈从的；缺乏独立性的；（似）仆人的；为仆人的；	***************<br />做单词时的意思：<br />abbr.<br />serva (Latin=keep, preserve) （拉丁<br />13<br />serva (Latin=keep, preserve) （拉丁
sex	做词根时的意思：<br />六<br />eg：<br />sexfoil<br />六叶装饰，六叶性的植物；六叶形；<br />sexangle<br />六角形，六边形；	***************<br />做单词时的意思：<br />n.<br />性别；两性之一；性，性特征；性活动；<br />vt.<br />辨识性别；引起性欲；吸引；
sid	做词根时的意思：<br />sit,坐<br />eg：<br />dissident<br />持异议者，公开大唱反调者，持不同政见者；  持不同意见的（人）；<br />reside<br />住，居住，（官吏）留驻，驻在；（性质）存在，具备，（权力，权利等<br />residence<br />住处，住宅；居住时间，居住；公馆；驻地；	***************<br />做单词时的意思：<br />abbr.<br />sidereal 星的；sudden infant death
sign	做词根时的意思：<br />mark,记号，信号<br />eg：<br />signal<br />信号，暗号；预兆，征象；动机；导火线；  向…发信号；用动作（手势）示意；以信号告知；  发信号；  显著的，优越的；暗号的，作信号用的；<br />assign<br />分派，选派，分配；归于，归属；[法律] 把（财产，权利、利息）从 [常用复数][法律]受让人，接受财产等转让的人，受托者；<br />assignment<br />分给，分配；任务，工作，（课外）作业；<美>任命；指定，委派；	***************<br />做单词时的意思：<br />n.<br />符号；手势；迹象；指示牌；<br />vt.& vi.<br />签名；打手势；
simil	做词根时的意思：<br />alike,same,相类似，一样<br />eg：<br />similar<br />类似的；同类的；相似的；同样的；  类似物；相像的人；相似物；<br />similarity<br />类似；相像性；相仿性；类似性，相似物；<br />simile<br />（使用like或as等词语的）明喻；	***************<br />做单词时的意思：
simul	做词根时的意思：<br />alike,same,相类似，一样<br />eg：<br />simulate<br />假装，冒充；模仿；模拟；[生]拟态；  模仿的；假装的；<br />simultaneous<br />同时发生的，同时存在的；同时的；联立的；  同时译员；<br />simultaneity<br />同时发生，同时；同时性；	***************<br />做单词时的意思：<br />adv.<br />（处方用语），一起，同时；
sinu	做词根时的意思：<br />bend,弯曲<br />eg：<br />sinuous<br />弯曲的，蜿蜒的；<br />insinuate<br />暗示；巧妙或迂回地潜入；（使）缓慢进入；慢慢伸入；<br />sinuation<br />曲折；	***************<br />做单词时的意思：
sist	做词根时的意思：<br />站，站立<br />eg：<br />resist<br />抵抗，抗拒；忍耐；反对，抵制；  防染剂；防腐剂；<br />assist<br />帮助；援助；机器助手；辅助装置；  帮助；援助；帮助某人做某事；搀扶（某人）上下车；  援助；出席；参加；<br />assistant<br />助手，助理；[化学]（染色的）助剂；辅助物；店员，伙计；  助理的；辅助的；有帮助的；副的；	***************<br />做单词时的意思：<br />abbr.<br />塞斯特；斯洛文尼亚标准化协会；
soc	做词根时的意思：<br />companion,同伴，引申为“社会”<br />eg：<br />sociable<br />随和的，好交际的，友善的；  〈美〉恳亲会；〈英〉对座四轮马车；（二人座）S形椅子；<br />social<br />社会的，社会上的；交际的，社交的；群居的；合群的；  联谊会，联欢会；社交聚会；<br />society<br />社会；上流社会；社团；社群；  上流社会的，社交界的；	***************<br />做单词时的意思：<br />abbr.<br />society 社会；social 社会的；sociology
sol	做词根时的意思：<br />alone,单独<br />eg：<br />sole<br />单独的；惟一的；专有的，独占的；  鞋底；有…底的 -soled；脚底；鳎（可食用比目鱼）；  给（鞋）换底；<br />solitary<br />独自的，独立的；单个的；唯一的；隐居的；  独居者，隐士；单独禁闭；<br />solitude<br />单独，孤独；偏僻处，隐居处；幽静（的地方），荒野；	***************<br />做单词时的意思：<br />n.<br />大音阶的第五音，溶胶；
solot	做词根时的意思：<br />loosen,松开<br />eg：<br />solution<br />解决；溶解；溶液；答案；<br />absolute<br />绝对的，完全的；不受任何限制[约束]的；无条件的；有无上权力或权 绝对；绝对事物；<br />dissolute<br />放荡的，淫乱的；猖；浪荡；风流；	***************<br />做单词时的意思：
solv	做词根时的意思：<br />loosen,松开<br />eg：<br />solve<br />解决；解答；解释；清偿（债务）；<br />soluble<br />[化] 可溶的；可以解决的；可以解释的；[数]可解的；<br />solvent<br />[化]溶剂，溶媒；解释，说明；解决方法；使瓦解的东西；  有溶解能力的，可溶解的；有清还债务能力的；起瓦解作用的；	***************<br />做单词时的意思：<br />abbr.<br />solve (Latin=dissolve) （拉丁语）溶解；s
somn	做词根时的意思：<br />sleep,睡眠<br />eg：<br />insomnia<br />[医]失眠，失眠症；<br />somnambulate<br />梦游；<br />somniloquy<br />说梦话；	***************<br />做单词时的意思：
son	做词根时的意思：<br />sound,声音<br />eg：<br />supersonic<br />[物]超声的，超音速的；  超声波；〈口〉超音速飞机；<br />dissonant<br />不和谐的；刺耳的；不调和的；自相矛盾的；<br />consonant<br />辅音，子音；辅音字母；  一致的；符合的；协和音的；和音的；	***************<br />做单词时的意思：<br />n.<br />儿子；孩子；男性后裔；圣子（耶稣基督）；
soph	做词根时的意思：<br />wise,智慧，聪明<br />eg：<br />sophism<br />谬论，诡辩；<br />sophisticated<br />复杂的；精致的；富有经验的；深奥微妙的；  使变得世故；使迷惑；篡改(sophisticate的过去分词形式<br />sophomore<br />（中等、专科学校或大学的）二年级学生；	***************<br />做单词时的意思：<br />n.<br /><美口>大学二年级生，有二年经验的人；
speci	做词根时的意思：<br />look, kind, 外观，种类<br />eg：<br />special<br />特殊的；专门的；专用的；重要的；  专车；特价；特刊；特约稿；<br />specialize<br />专门从事；专攻；详细说明；特化；  使专门化；使适应特殊情况；详细说明；列举；<br />specific<br />明确的；特种的；具体的；[免疫学]特效的；  特效药；特性；细节；显著的性质，特性；	***************<br />做单词时的意思：
spect	做词根时的意思：<br />look,see,看<br />eg：<br />aspect<br />方面；面貌；方位，方向；形势；<br />circumspect<br />谨慎小心的，周到的；<br />expect<br />期望；预料；要求；认为（某事）会发生；  预期；期待；怀胎；怀孕；	***************<br />做单词时的意思：<br />abbr.<br />single photonemission-computed t
sper	做词根时的意思：<br />hope, 希望<br />eg：<br />desperate<br />绝望的；由绝望而引起的；铤而走险的，孤注一掷的；急切的，极度渴望<br />desperado<br />亡命徒，暴徒；<br />despair<br />绝望；使人绝望的人（或事物）；  绝望；	***************<br />做单词时的意思：<br />abbr.<br />solid-phase epitaxial regrowth 固
spers	做词根时的意思：<br />scatter,散开<br />eg：<br />disperse<br />（使）分散，（使）散开；散播，传布（如知识）；使（光）色散；使粒 分散的；<br />aspersion<br />诽谤，中伤；（天主教）洒圣水；<br />intersperse<br />散布，散置；点缀；	***************<br />做单词时的意思：
spic	做词根时的意思：<br />look,see,看<br />eg：<br />suspicion<br />怀疑；嫌疑；疑心；〈口〉一点儿；  怀疑；<br />suspicious<br />可疑的；猜疑的，怀疑的；多疑的，不信任的；多心；<br />speculate<br />思索，猜测，推测；  投机；推测；思索；	***************<br />做单词时的意思：<br />n.<br /><美俚><贬>美籍西班牙人，在美国讲西班牙语的人；
spir	做词根时的意思：<br />breathe,呼吸<br />eg：<br />spirit<br />精神，心灵；情绪；勇气；精髓；  神秘地带走；<br />spiritual<br />精神的；心灵的；高尚的，崇高的；宗教的；  圣歌（尤指美国南部黑人的）；教会事物；<br />aspire<br />渴望，立志，追求；〈诗，古〉登，升，高耸；	***************<br />做单词时的意思：<br />[医][=spirochaeta]螺旋体属；<br />0<br />[医][=spirochaeta]螺旋体属；
spond	做词根时的意思：<br />promise,承诺<br />eg：<br />respond<br />回答，响应；  作出反应，响应；回报或回复；  [建]（柱，拱基等的）对称，壁联；<br />respondent<br />回答者；[法]（特指离婚诉讼的）被告；[生]反应，反射；  应答的；有反应的；[法]被告的；<br />response<br />反应；回答，答复；[宗]回应经文，应唱圣歌；	***************<br />做单词时的意思：
stell	做词根时的意思：<br />star,星星<br />eg：<br />stellar<br />星的；星球的；主要的； 主角的；<br />constellation<br />星座；一群杰出人物；一系列（相关的想法、事物）；一群（相关的人）<br />stelliform<br />星形的，放射线状的；	***************<br />做单词时的意思：<br />n.<br />（牲畜的）保护围场；
step	做词根时的意思：<br />后，继或前夫（妻）的<br />eg：<br />stepbrother<br />（继母与其前夫或继父与其前妻所生的）哥哥，弟弟；<br />stepdaughter<br />继女，过继的女儿；<br />stepfather<br />继父；	***************<br />做单词时的意思：<br />n.<br />步，脚步；步骤，手段；步调；级别；<br />vt.& vi.<br />举步，行走；踩，踏上；跨入；轻快地走；<br />vi.<br />踏，踩；走；<br />vt.<br />跳舞；迈步；使成阶梯状；
stereo	做词根时的意思：<br />立体<br />eg：<br />stereogram<br />立体画，体视图，立体照相；<br />stereograph<br />立体画，立体照片；<br />stereosonic<br />立体声的；	***************<br />做单词时的意思：<br />adj.<br />立体声的；有立体感的；<br />n.<br />立体声；立体声系统；铅板；立体系统或立体像片；
still	做词根时的意思：<br />small drop,小水滴<br />eg：<br />distill<br />蒸馏，提取，滴下；  抽出…的精华；提炼；使渗出；使滴下；  蒸馏；精炼；作为精华产生；渗出；<br />instill<br /><美>逐渐使某人获得（某种可取的品质），逐步灌输；<br />instillation<br />灌输，滴，滴下；	***************<br />做单词时的意思：<br />adv.<br />仍，仍然；更，还要；静静地；〈诗〉常，不断地；<br />adj.<br />不动的，静止的；不狂暴的，温柔的；没有活力的，死气沉沉的；<br />n.<br />平静，寂静；剧照；静止摄影；蒸馏器；<br />vt.& vi.<br />（使某物）平静下来，安静；〈古〉烧（酒），蒸馏；<br />conj.<br />但是；然而；
stinct	做词根时的意思：<br />prick,刺，刺激<br />eg：<br />distinct<br />明显的，清楚的；卓越的，不寻常的；有区别的；确切的；<br />distinctive<br />有特色的，与众不同的；区别的，鉴别性的；独特；特异；<br />distinction<br />区别；荣誉；特质；卓越；	***************<br />做单词时的意思：
sting	做词根时的意思：<br />prick,刺，刺激<br />eg：<br />stingy<br />小气的，吝啬的；<br />distinguish<br />区分，辨别，分清；辨别是非；  区分，辨别，分清；辨别出，识别；引人注目，有别于；使杰出，使著名<br />distinguished<br />卓越的；著名的；受人尊敬的；显得重要的；  辨别，区别( distinguish的过去式和过去分词)；突出；	***************<br />做单词时的意思：<br />vt.<br />叮，螫；刺痛；精神上刺痛；刺激；<br />vi.<br />感到剧痛；刺，叮；<br />n.<br />螫伤处；（某些昆虫的）毒刺；（身体或心灵的）剧痛；（警察为抓捕罪
stit	做词根时的意思：<br />set up,place，建立，放<br />eg：<br />constitute<br />构成，组成；制定，设立；等同于；指派；<br />constitution<br />建立，组成；体格；构成方式；宪法；<br />constituent<br />选民；成分，构成部分；委托人；  构成的，组成的；选举的；有选举权的；	***************<br />做单词时的意思：<br />abbr.<br />Space Telescope Task Team (NASA)
struct	做词根时的意思：<br />build，建立<br />eg：<br />structure<br />结构；构造；建筑物；体系；  构成，排列；安排；<br />construct<br />修建，建造；构成；创立；[数]作图；  结构（物）；构想；概念；<br />reconstruct<br />重建；重现；改造；复兴；	***************<br />做单词时的意思：<br />[计][C]（数据类型）结构，结构体（定义关键字）；
sub-	做词根时的意思：<br />在下面，次一等，副手<br />eg：<br />subdue<br />征服；克制；制服；<br />subjugate<br />征服，降伏；<br />subliminal<br /><心>阈下的，潜意识的；太弱或太快以至于难以觉察的；	***************<br />做单词时的意思：<br />n.<br />潜水艇；代用品，代替者，替补队员；地铁；审校员；<br />vi.<br />做替身，做替补队员；做替身，审校（文稿）；
sum	做词根时的意思：<br />take,拿，取<br />eg：<br />consume<br />消耗，消费；耗尽，毁灭；吃光，喝光；烧毁；<br />consumer<br />消费者，顾客；[生态]取食者，食物链中以其他生物为食物的生物；<br />consuming<br />强烈的；消费的；  消耗(consume的现在分词)；	***************<br />做单词时的意思：<br />n.<br />总数；算术；金额；概略，要点；<br />vt.& vi.<br />总计；总结，概括；归纳；
summ	做词根时的意思：<br />add up,总，加<br />eg：<br />summit<br />顶点；高层会议；最高阶层；  最高级的；政府首脑的；<br />summary<br />摘要，概要；总结，一览；  概括的，总结的；即刻的，立即的；<br />summation<br />总和；加在一起；总结；概括；	***************<br />做单词时的意思：<br />abbr.<br />summarization 摘要；summarize 总结；su
sumpt	做词根时的意思：<br />take,拿，取<br />eg：<br />assumption<br />假定，假设；承担；想当然；采取；<br />presumption<br />推测，设想；放肆，傲慢；<律>推定；<br />sumptuous<br />豪华的；奢侈的；腆；美奂美轮；	***************<br />做单词时的意思：
super-	做词根时的意思：<br />超级，超过，过度<br />eg：<br />supernatural<br />超自然的；神的，与神有关的；神奇的，运用神力的；  超自然的事物，超自然现象；[美剧]邪恶力量；<br />superfluous<br />过多的；多余的；不必要的；奢侈的；<br />supercilious<br />高傲的，傲慢的；  高傲地，傲慢地；  高傲，傲慢；	***************<br />做单词时的意思：<br />adj.<br />超级的，极度的，过分的，超等的，极好的；面积的，平方的；<br />n.<br />特级品，特大号商品；<br />adv.<br />非常，过分地；<br />v.<br />用上浆纱布装（书脊）；担任跑龙套角色；
supra	做词根时的意思：<br />超…，超过<br />eg：<br />supramundane<br />远离俗世的；	***************<br />做单词时的意思：<br />adv.<br />在上，在前；
sur	做词根时的意思：<br />超过，在上面<br />eg：<br />surface<br />表面；外观，外表；地面。水面；  浮出水面；在表面工作；显露；  使浮出水面；使成平面；  表面的，外观的；外表上的，平地上的；肤浅的；<br />surpass<br />超过；优于；胜过；非…所能办到；<br />surrealism<br />超现实主义；	***************<br />做单词时的意思：<br />在来自古法语的英语中与super-同义；如：surrender；
sus	做词根时的意思：<br />在…下面<br />eg：<br />susceptible<br />易受影响的；易受感染的；善感的；可以接受或允许的；<br />suspect<br />猜疑（是）；怀疑，不信任；怀疑…有罪；  嫌疑犯；  怀疑；  可疑的；<br />suspend<br />暂停；延缓；挂；悬；	***************<br />做单词时的意思：<br />n.<br />怀疑，猜疑；
sym	做词根时的意思：<br />共同，相同<br />eg：<br />sympathy<br />意气相投，同感；同情，同情心；慰问；和谐的一致；<br />symphony<br />交响乐，交响曲；序曲，插曲；〈古〉和谐，和谐的东西；<br />symmetry<br />对称；对称美；整齐，匀称；	***************<br />做单词时的意思：<br />abbr.<br />symbol 符号；symmetry 对称；symphonic
syn	做词根时的意思：<br />共同，相同<br />eg：<br />synchronous<br />同时存在[发生]的，同步的；<br />synonym<br />同义词；<br />synthesis<br />综合；<化>合成；综合体；综合推理；	***************<br />做单词时的意思：<br />abbr.<br />synchronizing 同步；synchronization
tact	做词根时的意思：<br />touch,接触<br />eg：<br />intact<br />完整无缺的，未经触动的，未受损伤的；原封不动的；完好无缺；完好无<br />tact<br />机智，机敏；老练，圆滑；[乐]拍子；〈罕〉触觉；<br />tactics<br />战术；策略，手段；用兵学；[语]法素学；	***************<br />做单词时的意思：<br />n.<br />机智，机敏；老练，圆滑；[乐]拍子；〈罕〉触觉；
tag	做词根时的意思：<br />touch,接触<br />eg：<br />contagious<br />有传染性的；传染病的；有感染力的；会蔓延的；<br />contiguous<br />接触的，邻近的，共同的；<br />contagion<br />传染；接触传染；道德败坏；歪风；	***************<br />做单词时的意思：<br />vt.<br />加标签于；附加；起诉；紧跟；<br />vi.<br />跟在…后面；随从；<br />n.<br />标签；附属物；口头禅；称呼；
tain	做词根时的意思：<br />hold，拿住<br />eg：<br />attain<br />达到，获得；遂愿；经过努力到达某事物；  达到，实现；获得；到达；  达到；获得；到达；<br />attainment<br />达到；成就，造诣；学识；<br />contain<br />包含，容纳；克制，遏制；牵制；包括或由…构成；	***************<br />做单词时的意思：<br />n.<br />薄锡板，锡箔；
tect	做词根时的意思：<br />cover,盖上<br />eg：<br />detect<br />查明，发现；洞察；侦察，侦查；[电子学]检波；<br />detection<br />侦查；察觉；发觉；检查；<br />detective<br />侦探的；适于探测的；用于探测的；  侦探；	***************<br />做单词时的意思：
tele	做词根时的意思：<br />far,远<br />eg：<br />telegraph<br />电报；电讯；电报机；信号机；  打电报；流露出；电汇；用电报通知；  用电报发送；打电报向（某人）发指令；电汇；电购；<br />telephone<br />电话；电话机；（电话机的）话筒；受话器；  以电话传送（消息），给（某人）打电话；用电话与（某人）交谈；<br />telescope<br />望远镜；  （使某物）变短（叠缩在一起）；（使某物）叠缩，嵌入；  压缩某物使其少占空间或时间；	***************<br />做单词时的意思：<br />n.<br />电视；<br />adj.<br />远距离的；远的；电视的；通过电话的 ；
tempor	做词根时的意思：<br />time，时间<br />eg：<br />temporary<br />临时的，暂时的；短暂的；  临时工，临时雇员；<br />temporal<br />时间的；世俗的；暂存的；<语>表示时间的；  暂存的事物，世间的事物；世俗的权力；一时的事物，俗事；<br />temporize<br />敷衍；拖延；顺应时势；暂时同意；	***************<br />做单词时的意思：
tempt	做词根时的意思：<br />try,尝试<br />eg：<br />attempt<br />试图；尝试；  进攻；尝试，冲击；<br />contempt<br />轻视；轻蔑；（对规则、危险等的）藐视；不顾；	***************<br />做单词时的意思：<br />vt.<br />引诱，怂恿；吸引；冒…的风险；使感兴趣；<br />vi.<br />有吸引力；
tend	做词根时的意思：<br />stretch，伸展<br />eg：<br />attend<br />出席；致力于，献身于；侍候，照顾；关注；  出席，参加；[常用被动语态]（作为结果、情况）伴随；照顾；陪伴；<br />attendant<br />服务人员，侍者；随从，随员；伴随物；  伴随的，随之而产生的；出席的；护理的；<br />attention<br />注意，注意力；照料，关怀；殷勤；  [口令]立正；	***************<br />做单词时的意思：<br />vt.<br />照料，照顾；护理；照管，管理；<br />vi.<br />倾向（于），趋向（于）；伺侯，招待；关心；注意；
tenu	做词根时的意思：<br />thin，细，薄<br />eg：<br />tenuous<br />薄的，细的；精细的；稀薄的；贫乏的；<br />attenuate<br />（使）变细；（使）变薄；（使）变小；减弱；  稀薄的；细小的；减弱的；减少的；<br />extenuate<br />（用偏袒的辩解或借口）减轻；低估，藐视；	***************<br />做单词时的意思：
termin	做词根时的意思：<br />limit ，界限<br />eg：<br />terminal<br />末期的；晚期的；定期的；末端的；  终端；终点站；航空站；（电路的）端子；<br />terminate<br />结束；使终结；解雇；到达终点站；  结束的；<br />termination<br />终止妊娠；结束；终止处；结局；	***************<br />做单词时的意思：
terr	做词根时的意思：<br />earth,土地<br />eg：<br />terrain<br />地形，地势；地面，地带；[地理]岩层；（知识的）领域范围；<br />terrace<br />台阶，阶地；阳台；柱廊，门廊；斜坡上房屋间的街巷；  把（如山坡或坡地）修成梯田；给（如房屋）建阳台；<br />subterranean<br />地表下面的，地下的；隐藏的；暗中的；  地下室；生活在地下的人；地下生存的动物（东西）；	***************<br />做单词时的意思：<br />n.<br />恐怖分子（罗得西亚白人称黑人民族主义游击队员的用语）；
tetra	做词根时的意思：<br />四<br />eg：<br />tetragon<br />四角形；方照；<br />tetracycline<br />四环素；	***************<br />做单词时的意思：<br />n.<br />脂鲤；
text	做词根时的意思：<br />weave，编织<br />eg：<br />textile<br />纺织品，织物；纺织业；<br />context<br />上下文；背景；环境；语境；<br />pretext<br />借口，托辞；假象，掩饰；  借口，假托；	***************<br />做单词时的意思：<br />n.<br />文本，原文；课文，教科书；主题；版本；<br />v.<br />发短信；
the	做词根时的意思：<br />god,神<br />eg：<br />atheism<br />无神论；<br />theocracy<br />神权政治（国家）；<br />apotheosis<br />尊为神圣；神化；美化；颂扬；	***************<br />做单词时的意思：<br />art.<br />指已提到的人（物）；指说话人与听者已知的人（物）；用于独一无二的
therm	做词根时的意思：<br />heat，热<br />eg：<br />thermal<br />热的，保热的；温热的；  上升的暖气流；<br />thermometer<br />温度计；体温表；<br />isotherm<br />等温线；	***************<br />做单词时的意思：<br />n.<br />克卡，小卡，千卡；
thesis	做词根时的意思：<br />setting，放置<br />eg：<br />thesis<br />论文，毕业论文；论点，论题；命题；<br />antithesis<br />对立；对立面；对照；对偶；<br />hypothesis<br />假设，假说；[逻]前提；	***************<br />做单词时的意思：<br />n.<br />论文，毕业论文；论点，论题；命题；
tim	做词根时的意思：<br />fear，害怕<br />eg：<br />timid<br />胆小的；羞怯的；怕人；羞手羞脚；<br />timidity<br />胆怯，羞怯；<br />intimidate<br />恐吓，威胁；	***************<br />做单词时的意思：<br />abbr.<br />timing 定时；technical information
tir	做词根时的意思：<br />draw,拉<br />eg：<br />entire<br />全部的；整个的；全体的；囫囵；<br />retire<br />退休；撤退；后退，退却；  退休，退隐；使撤退；收回；  退休；退隐；退兵信号；<br />tirade<br />激烈的长篇指责或演说；	***************<br />做单词时的意思：<br />abbr.<br />target illuminating radar 目标照射雷达
tom	做词根时的意思：<br />cut,切割<br />eg：<br />atom<br />原子；原子能；微粒，微量；<br />anatomy<br />解剖，分解，分析；（详细的）剖析；（生物体的）解剖结构；骨骼；<br />epitome<br />缩影；典型的人或事物；（书、演讲等的）摘要；	***************<br />做单词时的意思：<br />n.<br />雄动物，雄猫；
torn	做词根时的意思：<br />turn，转，环绕<br />eg：<br />tornado<br />[大气]龙卷风，陆龙卷；大雷雨；具有巨大破坏性的人（或事物）；<br />attorney<br />代理人；律师；<br />tourniquet<br />止血带；	***************<br />做单词时的意思：<br />v.<br />撕( tear的过去分词)；扯裂；破损；
tort	做词根时的意思：<br />twist,扭曲<br />eg：<br />torture<br />拷问；折磨；痛苦；（精神上或肉体上的）折磨；  使痛苦；使苦恼；使焦急；曲解；<br />tortuous<br />扭曲的，弯曲的；曲折的；不正派的，不正当的；转弯抹角的；<br />contort<br />扭曲，扭弯；	***************<br />做单词时的意思：<br />n.<br /><律>民事侵权行为；
tour	做词根时的意思：<br />turn，转，环绕<br />eg：<br />tourist<br />旅行者，观光客；〈美〉冬季到南部做工的流动工人；<br />contour<br />外形，轮廓；（地图上表示相同海拔各点的）等高线；概要；电路；  画轮廓（等高线）；  显示轮廓的；<br />detour<br />绕路，绕道；  绕道；弯路；	***************<br />做单词时的意思：<br />n.<br />旅行，观光；巡回演出；任职期；轮班；<br />vt.<br />到…旅游；在…巡回演出；<br />vi.<br />观光；巡回；
tox	做词根时的意思：<br />poison,毒<br />eg：<br />toxin<br />毒素；毒质；<br />toxic<br />有毒的；中毒的；因中毒引起的；  毒物；毒剂；<br />intoxicate<br />使喝醉；使陶醉； 使激动不已； 使欣喜若狂；	***************<br />做单词时的意思：<br />abbr.<br />toxic 有毒的；toxicity 毒性；toxin 毒素；t
tract	做词根时的意思：<br />draw，拉，拖<br />eg：<br />attract<br />吸引；诱惑；引起…的好感（或兴趣）；  具有吸引力；引人注意；<br />attraction<br />吸引；[物]引力；魅力；引人注意的东西，有趣的东西；<br />attractive<br />有魅力的；引人注目的；迷人的；招人喜爱的；	***************<br />做单词时的意思：<br />n.<br />大片土地；（神经纤维的）束；小册子；<古>一段时间，长时间；
trans-	做词根时的意思：<br />转移，移动，从点到点<br />eg：<br />transcend<br />超越，超出…的限度；优于或胜过…；高于或独立于（宇宙）而生存；<br />transgress<br />超越；越过；违反；违背；  做坏事；道德败坏；违反道德；犯法；<br />transmit<br />传输；传送，传递；发射；传染；  发送信号；	***************<br />做单词时的意思：<br />反式；
treat	做词根时的意思：<br />handle，处理<br />eg：<br />treaty<br />条约；协议，协商；谈判；<br />maltreat<br />虐待；亏待；<br />retreat<br />撤退，后退；撤销，作罢；（眼睛等）凹进；[航]向后倾斜；  撤回；静居处；引退期间；静思，静修；	***************<br />做单词时的意思：<br />n.<br />款待；招待；乐事；乐趣；<br />v.<br />对待；治疗；处理；款待；
trem	做词根时的意思：<br />quiver，颤抖<br />eg：<br />tremor<br />震颤；战栗；震颤声；大地的轻微震动；<br />tremulous<br />颤抖的；敏感的；胆小的；发抖的手所作的；<br />tremendous<br />极大的，巨大的；可怕的，惊人的；极好的；	***************<br />做单词时的意思：<br />abbr.<br />tremolando (Italian=trembling) （
tri	做词根时的意思：<br />三，三个<br />eg：<br />tripod<br />[摄]三脚架；三脚凳；三脚桌；三足鼎；<br />triple<br />三倍的，三方的，三部分的；  （使）增至三倍；  三倍的数[量]；三个一组；[棒]三垒安打；<br />tricycle<br />三轮车；	***************<br />做单词时的意思：<br />n.<br /><口>三个船体并列的游艇；
tridut	做词根时的意思：<br />give，给予<br />eg：<br />tributary<br />支流；进贡国；附庸国；进贡者；  （需向…）进贡的；附庸的；辅助的；支流的；<br />attribute<br />认为…是；把…归于；把…品质归于某人；认为某事[物]属于某人[物 属性；（人或物的）特征；价值；[语法学]定语；<br />contribute<br />贡献出；捐赠（款项）；投稿（给杂志等）；出力；	***************<br />做单词时的意思：
trud	做词根时的意思：<br />push，推<br />eg：<br />extrude<br />挤压出；挤压成；突出；伸出；  （被）挤压出；排出；喷出；  （把金属或塑料）挤压成，压制；<br />intrude<br />侵入，侵扰，打扰；闯入；打扰；  把观点强加于他人；[地质]侵入其他地层；把…硬挤；<br />intrusion<br />闯入；打扰；（对某事的）干扰；干涉；	***************<br />做单词时的意思：<br />[地名] [保加利亚、俄罗斯] 特鲁德；
tuine	做词根时的意思：<br />twine，编织<br />eg：<br />entwine<br />缠绕，盘绕；<br />intertwine<br />缠结在一起；使缠结；  纠缠；编结；<br />untwine<br />解开，拆开；	***************<br />做单词时的意思：
turb	做词根时的意思：<br />stir,搅动<br />eg：<br />disturb<br />打扰，妨碍；使骚动；使不安，使烦恼；妨碍睡眠（休息等）；<br />disturbance<br />打扰；骚乱，变乱；困扰；烦闷；<br />turbulent<br />骚乱的，混乱的；激流的，湍流的；吵闹的；强横的；	***************<br />做单词时的意思：<br />abbr.<br />turbidity 混浊，混乱；turbine 涡轮；<br />13<br />turbidity 混浊，混乱；turbine 涡轮；
twi	做词根时的意思：<br />二，两<br />eg：	***************<br />做单词时的意思：<br />abbr.<br />training within industry 企业内训练；t
ultra-	做词根时的意思：<br />极端<br />eg：<br />reactionary<br />反动的；保守的；[化]反应的；  反动派；保守分子；<br />ultramilitant<br />极端好战的，极端好斗的，极其富于战斗性的；<br />ultrapure<br />超纯的；	***************<br />做单词时的意思：<br />adj.<br />过激的，极端的；<br />n.<br />过激论者，急进论者；
umbr	做词根时的意思：<br />shadow,影子<br />eg：<br />umbrage<br />生气；（常指无故）不快；树荫；愤怒；<br />penumbra<br />黑影周围的半阴影；半影；边缘；外围；<br />adumbrate<br />约略显示，勾画出…的轮廓；  预示；预兆；遮蔽； 遮暗；	***************<br />做单词时的意思：
un-	做词根时的意思：<br />不，无，非，没有<br />eg：<br />unassuming<br />谦逊的，不装腔作势的，不招摇的；平易；<br />uncommitted<br />不受（某政策、做法、团体等）约束的；未做承诺的；未遂的；未被监禁<br />unscrupulous<br />肆无忌惮的，不择手段的，无道德原则的；没有节操的；恣意；	***************<br />做单词时的意思：<br />pron.<br />家伙，东西；
und	做词根时的意思：<br />wave，波动<br />eg：<br />abundant<br />大量的，充足的；丰富的，富有的；丰足；阜；<br />abundance<br />丰富，充裕；大量，极多；盈余；丰度；<br />undulate<br />起伏；波动；呈波浪形；震动；  波动；使波动；使起伏；使成波浪形；  波状的；波动起伏的；波浪形的；	***************<br />做单词时的意思：<br />abbr.<br />undated 无日期的；未注日期的；under 在…下面；在…<br />13<br />undated 无日期的；未注日期的；under 在…下面；在…
under-	做词根时的意思：<br />在…下<br />eg：<br />underground<br />地下的；秘密的；先锋派的；隐蔽的；  在地下；秘密地，偷偷地；  地铁；地下组织或活动；地道；地下；<br />underwrite<br />签名承认（担保），签名接受（保险）；给…保险；认购；在…下面写； 经营保险业；<br />undermine<br />逐渐削弱；使逐步减少效力；从根基处破坏；挖…的墙脚；	***************<br />做单词时的意思：<br />prep.<br />在…下面，在表面之下；在…的假定表面或掩饰下；少于，小于；在…情<br />adv.<br />在下面；少于；在水下；在昏迷中；<br />adj.<br />较低的，下面的；
uni	做词根时的意思：<br />单一，唯一，独一<br />eg：<br />uniform<br />制服；军服；通讯中用以代表字母 u 的词；  （形状，性质等）一样的；规格一致的；始终如一的；  使规格一律；使均一；使穿制服；<br />unique<br />唯一的，仅有的；独一无二的，独特的；不平常的，特别的；超绝；<br />unison<br />一致，协调；和谐；共同（做某事）；（音乐中的）齐唱；	***************<br />做单词时的意思：<br />单辊磨，复合压榨；
urb	做词根时的意思：<br />city,城市<br />eg：<br />suburbanite<br />郊区居民；<br />urban<br />都市的；具有城市或城市生活特点的；市内；<br />urbane<br />都市化的；彬彬有礼的，温文尔雅的；	***************<br />做单词时的意思：<br />abbr.<br />urban 都市的；urbanite 城市居民；urbaniza<br />13<br />urban 都市的；urbanite 城市居民；urbaniza
vac	做词根时的意思：<br />empty,空<br />eg：<br />vacuum<br />真空；空白；空虚；清洁；  用真空吸尘器清扫；<br />vacuous<br />空虚的；愚蠢的；茫然若失的；无聊的；  无意义地，茫然若失地，无所事事地；  空虚，无聊，愚蠢；<br />vacant<br />空闲的；空缺的；空虚的；茫然的；	***************<br />做单词时的意思：<br />n.<br />休假；
vad	做词根时的意思：<br />go,走<br />eg：<br />evade<br />逃避，躲避；避开；规避；逃脱；  逃避；规避；逃脱；<br />evasion<br />逃避，规避，躲避某人；遁辞，借口；<br />evasive<br />逃避的；推托的；闪烁其词的，含糊的；鬼；	***************<br />做单词时的意思：<br />n.<br />增值与数据网络；
vag	做词根时的意思：<br />wader，漫游<br />eg：<br />vagary<br />奇想，奇特行为；异想天开；怪异多变；<br />vagabond<br />流浪者，游手好闲者；  流浪的；流浪者的；漂泊的；声名狼藉的；<br />extravagant<br />过度的，过分的；奢侈的，浪费的；放肆的；大量的；	***************<br />做单词时的意思：<br />n.<br /><俚>流浪汉，游民；以流浪罪拘捕；
vail	做词根时的意思：<br />strong，强壮<br />eg：<br />avail<br />效用，利益；  有益于，有益于；使对某人有利；<br />available<br />可获得的；有空的；可购得的；能找到的；<br />prevail<br />流行，盛行；获胜，占优势；说服，劝说；	***************<br />做单词时的意思：<br />n.<br />小费；<br />v.<br />放下；脱下；降低；脱帽；
val	做词根时的意思：<br />strong，强壮<br />eg：<br />invalid<br />无效的；不能成立的；有病的；病人用的；  使伤残；使退役；失去健康；  病人，病号；残废者；伤病军人；  变得病弱；因病而奉命退役；<br />valor<br />（尤指战斗中的）勇猛，英勇；<br />valiant<br />勇敢的，英勇的；坚定的；  勇敢的人，勇士；	***************<br />做单词时的意思：<br />n.<br />英国压力单位，等于10N/M；克当量；
van	做词根时的意思：<br />empty,空<br />eg：<br />vanity<br />虚荣，浮华；自负；空虚，无聊的事物；无价值的东西；<br />vanish<br />消失；突然不见；消亡，消灭；[数]化为零；  使消失，使不见；  [语音学]消失音，弱化音；<br />evanescent<br />迅速消失遗忘的，短暂的；生命无常；	***************<br />做单词时的意思：<br />n.<br />先锋；厢式货车；增值网；先驱，前驱，领袖，领导人；<br />vt.<br />用车搬运；<br />prep.<br />〈外〉同“from”；
vari	做词根时的意思：<br />change,变化<br />eg：<br />variable<br />变化的，可变的；[数]变量的；[生]变异的；  可变因素，变量；易变的东西；<br />variance<br />变化，变动；不一致；分歧；<数>方差；<br />various<br />各种各样的；多方面的；许多的；各个的，个别的；	***************<br />做单词时的意思：<br />abbr.<br />various 不同的；各种各样的；许多的；varityper
ven	做词根时的意思：<br />com,来<br />eg：<br />venture<br />冒险事业；冒险；冒险行动；商业冒险；  冒…的危险；拿…冒险；用…进行投机；以…做赌注；  冒险前进，冒险行事；猜测（常与at连用）；<br />venturesome<br />（人）好冒险的；胆大的；（行动）有危险的；冒险（性）的；<br />adventure<br />冒险活动；冒险经历；奇遇；	***************<br />做单词时的意思：<br />[医][=vein]静脉，翅脉（昆虫）；
venge	做词根时的意思：<br />punish,惩罚，引申为“报仇”<br />eg：<br />vengeful<br />报复心驱使的，图谋报复的；渴望复仇的/报复的；<br />vengeance<br />报仇，复仇；报复；<br />avenge<br />为…复仇；为…报复；  报复；报仇；	***************<br />做单词时的意思：<br />vt.<br /><古>为…报仇，替…复仇；
ver	做词根时的意思：<br />true，真实<br />eg：<br />veracity<br />诚实，真实；<br />verisimilar<br />好像真实的；<br />verdict<br />（陪审团的）裁决；裁定；（经过试验、检验或体验发表的）决定；意见	***************<br />做单词时的意思：<br />n.<br />DOS命令：显示DOS版本号；
verb	做词根时的意思：<br />word，词语<br />eg：<br />adverb<br /><语>副词；<br />verbal<br />词语的；言语的；口头的；动词的；<br />verbatim<br />（完全）照字面的（地），逐字的（地）；  逐字翻译；	***************<br />做单词时的意思：<br />n.<br />动词；动词结构；
verse	做词根时的意思：<br />turn，转<br />eg：<br />verse<br />诗，韵文；诗节，诗行；诗篇；圣经中的节；  作诗或者从事于作诗；使熟练或者精通；<br />version<br />版本；译文，译本；说法；倒转术；<br />conversion<br />变换，转变；改装物；财产转换，兑换；[逻] 换位（法）；	***************<br />做单词时的意思：<br />n.<br />诗，韵文；诗节，诗行；诗篇；圣经中的节；<br />v.<br />作诗或者从事于作诗；使熟练或者精通；
vert	做词根时的意思：<br />turn，转<br />eg：<br />vertical<br />垂直的，竖立的；[解]头顶的；顶点的；[植]纵长的，直上的；  垂直线，垂直面；[建]竖杆；垂直位置；<br />avert<br />防止，避免；转移；<br />advertise<br />做广告，做宣传；通告，通知；宣扬；  登广告，做广告；做宣传；	***************<br />做单词时的意思：<br />n.<br />森林中的草木，绿色；倾侧；倾转；
vest	做词根时的意思：<br />clothes，衣服<br />eg：<br />vestment<br />礼仪服装；（尤指牧师的）法衣；圣衣；祭服；<br />divest<br />剥夺；脱去（衣服）；2。从…取去…；1。（给某人）脱衣服；<br />invest<br />投资；花费；  授予，使就职；给…穿衣，装饰；使充满；覆盖；	***************<br />做单词时的意思：<br />n.<br />马甲；防护衣；内衣；（印有运动员编号的）运动背心；<br />vi.<br />合法地被授予；给自己装上教服；<br />vt.<br />授权；赋予；穿衣服，穿教服；
vict	做词根时的意思：<br />conquer，overcome，征服，克服<br />eg：<br />victor<br />胜利者，获奖者；<br />victory<br />胜利；克服；成功；<br />convict<br />宣判有罪；证明…有罪；使知罪；定…的罪；  罪犯；	***************<br />做单词时的意思：<br />abbr.<br />Victoria 维多利亚（澳大利亚州名，加拿大港市名）；Vic
vid	做词根时的意思：<br />see,看<br />eg：<br />evident<br />明显的，明白的；昭著；彰；<br />evidence<br />证词；证据；迹象；明显；  使明显；显示；表明；证实；<br />invidious<br />会招致不满的，激起怨恨的；	***************<br />做单词时的意思：<br /><拉>请见，参阅；
vig	做词根时的意思：<br />life,生命<br />eg：<br />vigor<br /><美>（法律上的）效力；智力；（语言等的）气势；（动，植物的）强<br />vigorous<br />有力的；精力充沛的；充满活力的；朝气蓬勃的；<br />invigorate<br />使生气勃勃，使精力充沛，使健壮；  生气勃勃的，精力充沛的，健壮的；  滋补；鼓舞；	***************<br />做单词时的意思：<br />abbr.<br />vigorish 高额利息；
vince	做词根时的意思：<br />conquer，overcome，征服，克服<br />eg：<br />evince<br />表明，标示；<br />convince<br />使相信，说服，使承认；使明白；使确信；使悔悟，使认错[罪]；<br />convincing<br />令人相信的；有说服力的；令人心悦诚服的；  使相信(convince的现在分词)；使明白；使确信；说服；	***************<br />做单词时的意思：<br />n.<br />文斯(Vincent 的昵称)(m.)；
vir	做词根时的意思：<br />男<br />eg：<br />virile<br />有男子气概的；有生殖力的；强壮的；刚健的；<br />virilism<br />男性化现象；<br />virility<br />男性生殖力，男子气概；	***************<br />做单词时的意思：<br />n.<br />虚像；
vis	做词根时的意思：<br />see,看<br />eg：<br />advise<br />（商业）通知，报告；提议，建议；  接受劝告，商量；建议，提供意见；<br />advisory<br />劝告的，忠告的；提供咨询的；顾问的；  报告；公告；<br />revise<br />修订；改变；修正；[主英国英语]复习；  复习；  修订，校订；  修订；校订；[印刷]校样，清样；修订版，修订本；	***************<br />做单词时的意思：<br />n.<br /><拉>活力，精力；
vit	做词根时的意思：<br />life,生命<br />eg：<br />vital<br />维持生命所必需的；至关重要的；生死攸关的；生气勃勃的；<br />vitalism<br />活机论，生机说；<br />vitality<br />活力；生气；生命力；持久性；	***************<br />做单词时的意思：<br />abbr.<br />vitreous 玻璃的；vitamin 维他命；vital 活
viv	做词根时的意思：<br />life，生命<br />eg：<br />vivid<br />生动的；（记忆、描述等）清晰的；（人的想像）丰富的；（光、颜色等<br />vivisect<br />活体解剖，解剖；<br />convivial<br />好交际的；随和的；活跃的； 欢乐的；	***************<br />做单词时的意思：<br />n.<br />vortex-induced vibration 的縮寫海洋工程<br />1<br />vortex-induced vibration 的縮寫海洋工程
voc	做词根时的意思：<br />call voice，叫喊，声音<br />eg：<br />vocalist<br />声乐家；歌手；<br />vocation<br />职业，使命；神召，天命；<br />advocate<br />提倡；拥护；鼓吹；为…辩护；  （辩护）律师；提倡者；支持者；	***************<br />做单词时的意思：<br />abbr.<br />vocation 职业；vocational 职业的；vocal
vok	做词根时的意思：<br />call voice，叫喊，声音<br />eg：<br />convoke<br />召集，召开（会议）；<br />convocation<br />召集；正式集会；<br />irrevocable<br />不能取消的；不可改变的；不能挽回的；	***************<br />做单词时的意思：
volv	做词根时的意思：<br />roll，turn，卷，转<br />eg：<br />voluble<br />喋喋不休的；爱说话的；（指说话）快的；口若悬河的；<br />volume<br />量，大量；体积；音量；卷；  大量的；  成团卷起；  把…收集成卷；<br />voluminous<br />大的；多卷的；著作多的；宽松的；  宽松地，容量大地，篇幅长地；  宽松，容量大，篇幅长；	***************<br />做单词时的意思：
vor	做词根时的意思：<br />eat,吃<br />eg：<br />voracious<br />贪吃的；贪婪的；渴求的；如饥似渴的；  贪婪地；  贪婪，贪吃；<br />voracity<br />贪食，贪婪；<br />devour<br />狼吞虎咽地吃光；吞没，毁灭；全神贯注地看；	***************<br />做单词时的意思：<br />abbr.<br />very high frequency omnidirectio
vulg	做词根时的意思：<br />people,人群<br />eg：<br />vulgar<br />庸俗的，俚俗的，粗俗的；一般大众的，老百姓的；粗野的，下流的；  [古语]平民，百姓；<br />divulge<br />泄露；暴露；揭发；<古>公布，宣布；<br />vulgus<br />拉丁文或希腊文的作诗作业；	***************<br />做单词时的意思：<br />abbr.<br />vulgar 粗俗的；vulgarly 粗俗地；vulgaria<br />13<br />vulgar 粗俗的；vulgarly 粗俗地；vulgaria
vuls	做词根时的意思：<br />pluck，tear，收缩，撕开<br />eg：<br />convulse<br />使抽搐，使剧烈震动；<br />convulsion<br />[医]抽搐；大笑；震动；动乱；<br />revulsion<br />剧变；抽回；厌恶，强烈的反感；[医] 诱导法；	***************<br />做单词时的意思：
with	做词根时的意思：<br />向后，相反<br />eg：<br />withdraw<br />撤走；拿走；撤退；（从银行） 取 （钱）；  撤退；（从活动或组织中） 退出；<br />withhold<br />扣留；拒绝给予；抑制（某事物）；制止，阻挡；  忍住，克制；	***************<br />做单词时的意思：<br />prep.<br />和，跟；随着；关于；和…一致；
zoo	做词根时的意思：<br />animal，动物<br />eg：<br />zodiac<br />黄道带；黄道十二宫图；<罕>一圈；<br />azoic<br />无生命迹象的；（指时代等）无生的，无有机物遗骸的；<br />zoic<br />动物的；有生物的；动物生活的；含化石的；	***************<br />做单词时的意思：<br />n.<br />动物园；<美俚>（铁路货车的最后一节）守车；<美俚>核粒子园；
